0000000000000000000000000000000000000000000000000000000000000000000000000000000000000000000000000000
0000000000000000000000000000000000000000000000000000000000000000000000000000000000000000000000000000
0000000000000000000000000000000000000000000000000000000000000000000000000000000000000000000000000000
0000000000000000000000000000000000000000011111000000000000000000000000000000000000000000001100000000
0000000000000000000000000000000000000000111111100000000000000000000000000000000000000000011110000000
0000000000000000000000000000000000011111111111100000000000000000000000000000000000000000011111000000
0000000011000000000000000000000000111111111111000000000000000000000000000000000000000000011111000000
0000000111100000000000000000000001111111111110000000000011000000000000000000000000000000011111100000
0000000111111110000000000000000011111111111110000000000111110000000000000000000000000000011111110000
0000001111111111100000000000000011111111111100000000000111111000000000000000000000000000111111111000
0000011111111111110000000000000111111111111000000000000111111100000000000000000000000001111111111100
0000011111111111111000000000001111111111111000000000001111111110000000000000000000000011111111111100
0000011111111111111000000000001111111111111000000000011111111111110000000000000000000111111111111100
0000001111111111111000000000000111111111111000000000011111111111111000000000000000000111111111111100
0000000111111111110000000000000111111111111000000000001111111111111100000000000000000111111111111100
0000000011111111110000000000000011111111111000000000000111111111111110000000000000000111111111111100
0000000011111111110000000000000001111111111000000000000011111111111110000000000000000011111111111100
0000000011111111110000000110000001111111111100000000000011111111111110000000000000000001111111111100
0000000011111111110000001111000001111111111100000000000111111111111111000000000000000000111111111100
0000000011111111110000011111100011111111111110000000001111111111111111111100000000000000011111111100
0000000011111111110000011111111111111111111111000000001111111111111111111111000000000000001111111100
0000000011111111110000001111111111111111111111100000001111111111111111111111100000000000000011111000
0000000011111111111000001111111111111111111111110000001111111111111111111111111000000000000001111000
0000000011111111111100011111111111111111111111110000000111111111111111111111111100000000000001111000
0000000011111111111111111111111111111111111111111000000111111111111111111111111111111000000011111100
0000000001111111111111111111111111111111111111111000000011111111111111111111111111111100000111111100
0000000000111111111111111111111111111111111111110000000001111111111111111111111111111100001111111100
0000000000111111111111111111111111111111111111000000000001111111111111111111111111111110011111111100
0000000001111111111111111111111111111111111110000000000000111111111111111111111111111111111111111100
0000000011111111111111111111111111111111111110000000000000011111111111111111111111111111111111111100
0000000111111111111111111111111111111111111110000000000000011111111111111111111111111111111111111100
0000000111111111111111111111111111111111111111000000000000111111111111111111111111111111111111111100
0000001111111111111111111111111111111111111111110000000000111111111111111111111111111111111111111100
0001111111111111111111111110000111111111111111111000000000011111111111111111111111111111111111111100
0011111111111111111111111100000011111111111111111100000000011111111111111111111111111111111111111000
0111111111111111111111111100000011111111111111111110000000011111111111111111111111111111111111000000
0111111111111111111111111000000111111111111111111110000000111111111111111111111111111111111110000000
0011111111111111111111110000000111111111111111111110000001111111111111111111111111111111111110000000
0011111111111111111111110000000111111111111111111110000111111111111111111111111111111111111110000000
0011111111111111111111110000000111111111111111111111001111111111111111111111111111111111111111000000
0001111111111111111111110000000011111111111111111111111111111111111111111111111111111111111111110000
0001111111111111111111111000000001111111111111111111111111111111111111111111111111111111111111111000
0000111111111111111111111100000001111111111111111111111111111111111111111111111111111111111111111000
0000111111111111111111111110000001111111111111111111111111111111111111111111111111111111111111111100
0000011111111111111111111111000001111111111110011111111111111111111111111111111111111111111111111100
0000011111111111111111111111100001111111111100001111111111111111111111111100111111111111111111111000
0000001111111111111111111111110001111111111000000111111111111111111111111000011111111111111111111000
0000001111111111111111111111110001111111111000000111111111111111111111110000011111111111111111111000
0000001111111111111111111111100001111111111000000111111111111111111111110000011111111111111111110000
0000001111111111111111111111100001111111111000000011111111111111111111111000011111111111111111110000
0000000111111111111111111111110011111111111100000001111111111111111111111000011111111111111111111000
0000000011111111111111111111111111111111111100000000111111111111111111111000011111111111111111111100
0000000011111111111001111111111111111111111000000000111111111111111111111100111111111111111111111110
0000000111111111110000111111111111111111110000000000111111111111111111111111111111111111111111111110
0000111111111111100000011111111111111111100000000001111111111111111111111111111111111111111111111100
0001111111111111000000001111111111111111100000000001111111111111111111111111111111111111111111111100
0001111111111111000000001111111111111111100000000000111111111111111111111111111111111111111111111110
0001111111111111100000001111111111111111000000000000111111111111111111111111111111111111111111111110
0000111111111111111000001111111111111111000000000000111111111111111111111111111111111111111111111100
0000011111111111111100001111111111111111100000000001111111111111111111111111111111111111111111111100
0000001111111111111100001111111111111111110000000111111111111111111111111111111111111111111111111100
0000001111111111111100011111111111111111110000001111111111111111111111111111111111111111111111111100
0000001111111111111100011111111111111111100000001111111111111111111111111111111111111111111111111100
0000001111111111111100001111111111111111100000011111111111111111111111111111111111111111111111111110
0000001111111111111100000001111111111111110000011111111111111111111111111111111111111111111111111110
0000001111111111111110000000111111111111111000011111111111111111111111111111111111111111111111111100
0000001111111100111110000000111111100011111100001111111111111111111111111111111111111111111111111100
0000001111110000011111000001111111000001111110001111111111111111111111111111111111111111111111111100
0000000111100000011111111111111111000001111110001111111111111111111111111111111111111111111111111100
0000000111100000011111111111111111100011111111111111111111111111111111111111111111111111111111111100
0000000111100000001111111111111111111111111111111111111111111111111111111001111111111111111111111100
0000000111110000001111111111111111111111111111111111111111111111111111110000111111111111111111111100
0000000111111000001111111111111111111111111111111111111111111111111111110000111111111111111111111100
0000000011111110011111111111111111111111111111111111111111111111111111111001111111111111111111111100
0000000000001111111111111111111111111111111111111111111111111111111111111111111111111111111111111100
0000000000000111111111111111111111111111111111111111111111111111111111111111111111111111111111111000
0000000111000111111111111111111111111111111111110011111111111111111111111111111111111111111111111000
0000001111100111111111111111111111111111111111100001111111111111111111111111111111111111111111111000
0000001111100011111111111111111111111111111111100001111111111111111111111111111111111111111111111000
0000001111100011111111111111111111111111111111110011111111111111111111111111111110011111111111111000
0000011111100001111111111111111111111111111111111111111111111111111111111111111100001111111111111000
0000111111100001111111111111111111111111111111111111111111111111111111111111111100001111111111111100
0000111111110001111111111111111111111111111111111110011111111111111111111111111100001111111111111100
0000111111110001111111111111111111111111111111111100001111111111111111111111111100011111111111111100
0000111111111000111111111111111111111111111111111000000111111111111111111111111110011111111111111100
0000111111111100011111111111111111111111111111111000000011111111111111111111111111111111111111111100
0001111111111100011111111111111111111111111111111000000000111111111111111111111111111111111111111100
0001111111111100011111111111111111111111111111111000000000011111111111111111111111111111111111111100
0000111111111100011111111111111111111111111111111100000000000001111111111111111111111111111111111100
0000000111111100011111111111111111111111111111111100000110000000111111111111111111111111111111111000
0000000011111100011111111111111111111111111111111110001111000000001111111111111111111111111111110000
0000000001111000011111111111111111111111111111111110001111100000000111111111111111111111111111110000
0000000000110000011111111111111111111111111111111111000111100000000111111111111111111111111111110000
0000000000000000001111111111111111111111111111111111000011000000000111111111111111111111111111111000
0000000000000000000111110011111111111111111111111110000000000000000111111111111111111111111111111100
0000000000000000000011100001111111111111111111111000000000110000000011111111111111111111111111111100
0000000000000000000000000001111111111111111111110000000001111000000001111111111111111111111111111000
0000000000000000000000000000111111111111111111110000000001111000000000111111111111111111111111110000
0000000000000000000000000000001111111000000111100000000000110000000000000111110011110001111111100000
0000000000000000000000000000000000000000000000000000000000000000000000000000000000000000000000000000
