0000000000000000000000000000000000000000000000000000000000000000000000000000000000000000000000000000
0000000000000000000000000000000000000000000000000000000000000000000000000000000000000000000000000000
0000000000000000000000000000000000000000000000000000000000111000000000000000000000000000000000000000
0000000000000000000000000000000000000011100000000000000001111100000000000000000011000000000000111000
0000000000000000000000000000000000000111110000000000000111111110000000000000000111100000000001111100
0000000000000000000000000000000000000111111000000000001111111111000000000000000111111100000001111100
0000000000000000000001110000000000000111111110000000011111110011110000000000001111111110000001111100
0000000000000000000011111000000000001111111111000000011111100001111000000001111111111111000001111100
0000000000110000000111111100000000011111111111000000011111000000111000000011111111111111000011111100
0000000001111111111111111110000000111111111111000000011110000000011000000111111111111111000111111110
0000000001111111111111111111000000111111111111100000111100000000001100000111111111111111001111111110
0000000001111111111111111111110000111111111111110000111100000000001110000111111111111110001111111110
0000000001111111111111111111111001111111111111111000111100000000011110000011111111111110001111111110
0000000001111111111111111111111111111111111111111111111100000000011110000001111111111110011111111100
0000000001111111111111111111111111111111111111111111111110000000111111000000111111111100011111111000
0000000001111111111111111111111111111111111111111111111111000001111111100000000000000000001111111000
0000000001111111111111111111111111111111111111111111111111000011111111110000000000000000001111111000
0000000001111111111111111111111111111111111111111111111111000111111111111000000000000000011111111000
0000000001111111111111111111111111111111111111111111111111000111111111111100000000000000011111110000
0000000000111111111111100111111111111111111111111111111111100111111111111110000000000000011111100000
0000000000011111111111000011111111111111111111111111111111100011111111111110000000000000111111100000
0000000000001111111111000011111111111111111111111111001111100011111111111110000000000000111111100000
0000000000001111111111000111111111111111111111110000000111100111111111111111000000000000111111110000
0000000000001111111110000111111111110011111111100000000011001111111111111111100000000000011111111000
0000000000001111111000000111111111100001111111000000000000001111111111111111110000000000011111111100
0000000000000111110000000111111111100001111111000000000000001111111111111111111000000000011111111100
0000000000000111110000000111111111110000111111100000000000001111111111111111111100000000111111111100
0000110000000111111000000111111111111000011111111100000000001111111111111111111110000011111111111110
0001111000000111111000000111111111111000001111111110000000001111111111111111111111111111111111111110
0001111000000011110000000111111111111000000011111110000000000111111111111111111111111111111111111100
0000110000000000000000000011111111111000000001111111000000000111100111111111111111110011111111111100
0000000000000000000000000011111111110000000001111111100000000111000011100001111111100001111111111000
0000000000000000000000000111111111100000000000111111110000001111000000000000111110000001111111111000
0000000000000110000000000111111111000000000000011111111000011110000000000000111100000001111111111100
0000000000001111000000000111111111000000000000001111111111111110000000000001111100000001111111111100
0000000000011111000000000011111111100000000000000111111111111110000000000001111100000001111111111100
0000000000011111100000000001111111110000000000000111111111111111000000000001111110000001111111111100
0000000000011111110000000000111111110000000000000111111111111111100000000000111110000001111111111110
0000000000111111111000000000011111110000000000000111111111111111110000000000111110000001111111111110
0000000001111111111100000000011111110000000000000111111111111111111000000000111111000000111111111110
0000000011111111111100000000011111111000000000000011111111111111111000000000111111000000111111111100
0000000111111111111000000000001111111000000111000001111111111111111000000000011111000000111111111100
0000000111111111111000000000000111111000001111100001111111111111111000000000001111100000111111111100
0000000111111111111000000000000001111100011111110011111111111111111100000000000011110000111111111100
0000000011111111111100110000000000111111111111111111111111111001111110000000000001111001111111111100
0000000011111111111111111000000000011111111111111111111111110000111111000000000001111111111111111100
0000000011111111111111111000000000001111111111111111111111110000011111100000000011111111111111111100
0000000111111111111111111100000000000110001111111111111111110000011111100000000011111111111111111100
0000001111111111111111111100000000000000000111111111111111111000001111110000000011111111111111111100
0000001111111111111111111000000000000000000111111111111111111100001111111000000011111111111111111100
0000001111111111111111111000000000000000000111111111111110001110001111111111100111111111111111111100
0000001111111111111111111100000000000000000011111111111100000110001111111111111111111111111111111110
0000001111111111111111111110000000000000000001111111111000000110000111111111111111111111111111111110
0000001111111111111111111111000000000000000000011111110000001111000011111111111111111111111111111100
0000001111111111111111111111000000000000000000000111110000001111000011111111111111111111111111111000
0000000111111111111111111111000000000000000000000011111000011110000011111111111111111111111111111000
0000000000000111111111111111100000000000000000000001111100011110000001111111111111111111111111111000
0000000000000011111111111111111100000000000000000000111100011110000001111111111111100111111111111100
0000000000000011111111111111111110000000000000000000011000011111000001111111111111000011111111111110
0000000000000001111111111111111111000000000000000000000000001111100001111111111111000011111111111110
0000000000000001111111111111111111000000000000000000000000001111100011111111111111100111111111111110
0000001100000000111111111111111111100000110011000000000000001111100111111111111111111111111111111110
0000011110000000001111111111111111100001111111100000000000011111100111111111111111111111111111111100
0000011110000000000111111111111111110011111111110000000000111111111111111111111111111111111111111100
0000001100000000000111111111111111111111111111110000000001111111111111111111111111111111111111111000
0000000000000000000111111111111111111111111111100000000111111111111111111111111111111111001111111000
0000000000000000000111111111111111111111111111100000001111111111111111111111111111111110000111111100
0000000000000000000111111111111111111111111111100000001111111111111111111111111111111110000111111100
0000000000011100000111111111111111111111111111100000000111111111111111111111111111111111001111111000
0000000000111110001111111111111111111111111111000000000111111111111111111111111111111111111111111000
0000000001111111111111111111100111111111111111000000000111111111111111111111111111111111111111111100
0000111111111111111111111111000011111111111110000000000011111111111111111111111111111111111111111100
0001111111111111111111111110000001111111111110000000000011111111111111111111111111111111111111111100
0011111111111111111111111110000001111111111110000000000001111111111111100111111111111111111111111100
0011111111111111111111111110000000111111111111000000000001111111111111000000011111111111111111111110
0011111111111111111111111110000000001111111111000000000001111111111110000000001111111111111111111110
0011111111111111111111111111000000000001111111000000000000111111111110000000001111111111111111111110
0011111111111110011111111111000000000000111111000000000000011100011111000000001111110001111111111110
0001111111111100001111111111000000000000011111100000000000000000001111111100001111100000111111111100
0001111111111100001111111110000000000000001111100000000000000000000111111110011111100000111111111100
0001111111111100000111111110000000000000001111100000000000000000000111111111111111110001111111111100
0001111111111000000011111110000000000000001111100000000000000000000111111111111111111111111111111100
0011111111111000000001111111000000000000000111110000000000000000000111111111111111111111111111111100
0011111111111100000000111111100000011100000111111100000001100000000111111111111111111111111111111100
0011111111111110000000011111100000111110000111111110000011110000001111111111111111111111111111111100
0001111111111111000000001111100000111111001111111111100111110000111111111111111111111111111111111100
0001111111111111110000001111000000111111111111111111111111100001111111111111111111111111111111111100
0001111111111111111000001111000000011111111111111111111111100001111111111111111111111111111111111000
0011111111111111111000000111000000011111111111111111111111100000111111111111111111111111111111110000
0011111111111111111100000011100000111111111111111111111111110000111111111111111111111111111111110000
0001111111111111111111000011110001111111111111111111111111110000111111111111111111111111111111111000
0001111111111111111111100111111111111111111111111111111111111000011111111111111111111111111111111100
0011111111111111111111111111111111111111111111111111111111111100001111111111111111111111111111111100
0111111111111111111111111111111111111111111111111111111111111110001111111111111111111111111111111100
0111111111111111111111111111111111111111111111111111111111111110001111111111111111111111111111111000
0011111111111111111111111111111111111111111111111111111111111111000111111111111111111111111111111000
0011111111111111111111111000111111111111111111111111111111111111000011111111111111111111111111111000
0011111111111111111111110000011111111111111111111111111111111111000001111100111111111110011001110000
0001111100000000000011100000001100000000111110000011111111001110000000111000011111111100000000000000
0000000000000000000000000000000000000000000000000000000000000000000000000000000000000000000000000000
