0000000000000000000000000000000000000000000000000000000000000000000000000000000000000000000000000000
0000000000000000000000000000000000000000000000000000000000000000000000000000000000000000000000000000
0000001111000000000000000000000000000000000000000000000000000000000000000000000000000000000000000000
0000011111100000000000000000000000000000000000011000000000000000000000000000000000000000000011100000
0000011111110000000000000000000000000000000000111100000000000000000000000000000001100000000111111000
0000001111111000000001111000000000000000000000111111000000000000000000000000000011111111111111111100
0000000111111111001111111100000000000000000000111111110000000000000000000000000011111111111111111110
0000000011111111111111111100000000000000000000111111111100000000000000000000000001111111111111111110
0000000011111111111111111110000000000000000000111111111110000000000000000000000001111111111111111110
0000000111111111111111111111110000000000000000111111111110000000000000000000000001111111111111111110
0000000111111111001111111111111110000000000000111111111100000000000000000000000000111111111111111100
0000000011111110000111111111111111000000000000111111111100000000000000000000000000111111111100111100
0000000011111110000111111111111111100000000000011111111110000000000000000000000000111111111000011000
0000000011111111000111111111111111100000000000001111111111110000000000000000000000111111110000000000
0000000111111111100011111111111111110000000000000111111111111000000000000000000001111111100000000000
0000001111111111100001111111111111111000000000000111111111111100000000000000000001111111000000000000
0000001111111111000000111111111111111100000000001111111111111110000000000000000001111111000000000000
0000001111111110000000011111111111111110000000011111111111111111000000000000000001111111100000000000
0000001111111100000000011111111111111111100000111111111111111111100000000000000011111111111000000000
0000000111111100000000011111111111111111110000111111111111111111110000000000111111111111111100000000
0000000011111110000000011111111111111111110000011111111111111111111000000001111111111111111100000000
0000000001111111111000011111111111111111100000011111111111111111111000000011111111111111111000000000
0000000001111111111100111111111111111111100000001111111111111111111000000011111111111111111000000000
0000000001111111111111111111111111111111100000000111111111111111111000000011111111111111111000000000
0000000000111111111111111111111111111111100000000111111111111111110000000111111111111111111000000000
0000000000011111111111111111111111111111110000000111111111111111100000000111111111111111111100000000
0000000000001111111111111111111111111111110000000111111111111111000000000011111111111111111110000000
0000000000001111111111111111111111111111110000000011111111111110000000000011111111111111111111000000
0000000000011111111111111111111111111111110000000011111111110000000000000011111111111111111111100000
0000000000111111111111111111111111111111110000000011111111100000000000000011111111111111111111110000
0000000000111111000011111111111111111111110000000011111111100000000000000011111111111111111111110000
0000000000111110000001111110011111111111110000000011111111110000000000000011111111111111111111100000
0000000000111110000000111100001111111111110000000001111111111111000000000001111111111111111111000000
0000000001111111000000011100001111111111100000000000000111111111100000000000111111111111111111000000
0000000011111111000000011110011111111111100000000000000011111111110000000000111111111111111111000000
0000011111111111100000011111111111111111110001100000000011111111111111100001111111111111111111000000
0000111111111111110000011111111111111111111111110000000011111111111111111111111111111111111111100000
0000111111111111110000001111111111111111111111110000000001111111111111111111111111111111111111110000
0000011111111111111000000011111111111111111111100000000001111111111111111111111111111111111111111000
0000001111111111111111100001111111111110011111100000000001111111111111111111111111111111111111111000
0000000111111111111111110001111111111100001111100000000001111111111111111111111111111111111111111000
0000000111111111111111110000111111111100001111110000000001111111111111111111111111111111111111111000
0000000111111111111111100000011111111100001111110000000001111111111111111111111111111111111111111100
0000000011111111111111000000011111111100000111111000000001111111111111111111111111111100011111111100
0000000011111111111110000000111111111110000111111100000000111111111111111111111111111000001111111100
0000000001111111111100000000111111111110000111111111100000111111111111111111111111111000001111111000
0000000000111111111100000001111111111110000111111111110000011111111111111111111111111000001111110000
0000000000111111111110011111111111111111000111111111111000011111111111111111111111111100011111110000
0000000001111111111111111111111111111111100111111111111100111111111111111001111111111111111111111000
0000000001111111111111111111111111111111100011111111111111111111111111110000111111111111111111111100
0000000001111111111111111111111111111111100011111111111111111111111111110000011111111111111111111100
0000000001111111111111111111111111111111000111111111111111111111111111110000001111111111111111111100
0000000000111111111111111111111111110000000111111111111111111111111111111000001111111111111111111100
0000000000111111111111111111111111100000000111111111111110000001111111111100001111111111111111111100
0000000000011111111111111111111111100000000111111111111100000000111111111100001111111111111111111100
0000000000001111111111111111111111100000001111111111100000000000000111111100001111111111111111111100
0000000000000111111111111111111111110000001111111111000000000000000011111110011111111111111111111100
0000000000000111111111111111111111111000011111111111000000000000000011111111111111111100111111111100
0000000000000011111111111111111111111100011111111111100000000000110001111111111111111000011111111100
0000000000000001111111111111111111111100001111111111110000000001111011111111111111111000001111111100
0000000000000001111111111111111111111100000111111111111110000001111111111111111111111000001111111100
0000000000000001110001111111111111111100000111111111111111000000111111111111111111111000011111111100
0000000000000011100000111111111111111100000011111111111111100000011111111111111111110000011111111100
0000000000000011100000011111111111111100000001111111111111110000011111111111111111100000011111111000
0000000000000001100000011111111111111110000000111111111111111000011111111111111111100000011111110000
0000000000000001100000001111111111111111000000111111111111111000001111111111111111100000111111100000
0000000000000001100000000111111111111111100000111111111111110000000111111111111111110000111111100000
0000000000000000000000000111111111111111110001111111111111110000000111111111111111111001111111100000
0000011000000000000000000111111111111111111111111111111111111000000111111111111111111111111111110000
0000111100000000000000001111111111111111111111111111111111111111001111111111111111111111111111111000
0000111100000000000000001111111111111111111111111111111111111111111111111111110011111111111111111000
0000111100000000000000001111111111111111111111111111111111111111111111111111100001111111111111111000
0000111100000000000000000111111111111111111111111111111111111111111111111111100000111111111111110000
0000011110000000000000000111111111111111111111111111111111111111111111111111100000011111111111100000
0000001111000000000000000111111111111111111111111111111111111111111111111111110000001111111111100000
0000001111100000000000000111111111111111111111111111111111111111111111111111111000001111111111100000
0000001111100000000000001111111111111100111111111111111111111111111111111111111100001111111111100000
0000000111100000000011111111111111111000011111111111111111111111111111111111111100001111111111100000
0000000011100001100111111111111111111000001111111111111111111111111111111111111110011111111111110000
0000000001110011111111111111111111111000000111111111111111111111111111111111111111111111111111111000
0000000001111111111111111111111111111000000111111111111111111111111111111111111111111111111111111100
0000000011111111111111111111111111111000000111111111111111111111111111111111111111111111111111111110
0000111111111111111111111111111111111000000111111111111111100111111111111111111111111111111111111110
0001111111111111111111111111111111111100000111111111111111000011111111111111111111111111111111111110
0001111111111111111111111111111111111110001111111111111110000001111111111111111111111111111111111110
0001111111111111111111111111111111111111111111111111110000000001111111111111111111111111111111111110
0001111111111111111111111111111111111111111111111111100000000001111111111111111111111111111111111110
0001111111111111111111111111111111111111111111111111100000000001111111111111111111111111111111111110
0001111111111111111111111111111111111111111111111111100000000001111111111111111111111111111111111110
0001111111111111111111111111111111111111110011111111000000000011111111111111111111111111111111111100
0000111111111111111111111111111111111111100001111110000000001111111111111111111111111111111111111100
0000111111111111111111111111111111111111100001111100000000011111111111111111111111111111111111111100
0000111111111111111111111111111111111111100001111000000000011111111111111111111111111111111111111100
0000011111111111111111111111111111111111100011111000000000011111111111111111111111111111111111111100
0000011111111111111111111111111111111111100011111100000000011111111111111111111111111111111111111100
0000111111111111111111111111111111111111100011111110000000011111111111111111111111111111111111111100
0001111111111111111111111111111111111111100011111110000000011111111111111111111111111111111111111100
0001111111100011111111111111111111111111000011111110000000001111111111111111111111111111111111111000
0000111111000001111000000000001111111000000001111100000000000000011000011100001110000111111111100000
0000000000000000000000000000000000000000000000000000000000000000000000000000000000000000000000000000
