0000000000000000000000000000000000000000000000000000000000000000000000000000000000000000000000000000
0000000001100000000000000000000000000000000000000000000000000000000000000000000000000000000000000000
0000000011110000000000000000000000000000000000000000000000000000000000000000000000000000000000000000
0000000011110000000000110000000000000000000000000000000000000000000000000000000000000000000000000000
0000000001100000000001111000000000000000000110000000000000011000000000000000000000000000000000000000
0000000000000000000011111100000000000000001111000000000000111100000000000011100000000000000001110000
0000001100000011000011111100000000000000001111000000000001111100000000000111110000000000000111111000
0000011110011111100111111110000000000000001111100000000001111000000000001111111000000000001111111000
0000011110111111111111111111000000000000001111100000000000110000000000001111111100000000001111111000
0000001100111111111111111111110000000000001111100000000000000000000000001111111110000000000111110000
0000000000111111111111111111111000000000000111110000000000000000000000001111111110000000000111100000
0000000001111111111111111111111100000000000000111110000000000000000000000111111110000000000111100000
0000000001111111111111111111111110000000000000011111000000000000000000000011111111000000001111100000
0000000001111111111111111111111111110000000000001111000000000000000000000001111111100000011111100000
0000000001111111111111111111111111111111000000001111100000000000000000000000111111110000111111100000
0000000011111111111111111111111111111111100000011111111110000000000001100000011111110001111111110000
0000000111111111111111111111111111111111111111111111111111000000000011110000011111110001111111111000
0000001111111111111111111111111111111111111111111111111111000000000111111000011111100000111111111100
0000011111111111111111111111111111100111111111111111111111000000001111111100111111000000011111111100
0000011111111111111111111111111111000011111111111111111111000000001111111111111111000000011111111100
0000011111111111111111111111111100000011111111111111111111100000001111111111111111100000011111111100
0000001111111111111111111111111000000011111111111111111111100000001111111111111111110000011111111100
0000001111111111111111111111110000000001111111111111111111100000001111111111111111111100111111111100
0000001111111111111111111111100000000001111111111100111111100000000111100111111111111111111111111100
0000011111111111111111111111100000000001111111111000011111110000000011000011111111111111111111111100
0000111111111111111111111111110000000001111111110000011111111000000000000011111111111111111111111100
0001111100111111111111111111110000000001111111110000011111111000000000000001111111111111111111111100
0001111000011111111111111111111000000011111111100000001111110000000000000000111111111111111111111100
0000111000011111111111111111111000000011111111000000001100000000000000000000001111111111111111111100
0000111100111111111111111111111000000001111110000000001000000011111111000000000111111111111111111100
0000111111111111111111111111111000000000111110000000011000000111111111100000000111111111111111111100
0000111111111111111111111111111100000000111111000000111000000111111111110000001111111111111111111110
0000111111110011111111111111111110000000111111100000111000001111111111110000011111111111111111111110
0000011111100001111111111111111111000000111111110001110000001111111111111000011111111111111111111110
0000011111100001111111111111111111100000011111111111110000001111111111111000001111111111111111111110
0000011111110011111111111111111111110000011111111111110000001111111111111100001111111111111111111100
0000011111111111111111111111111111111000001111111111111000000111111111111110011111111111111111111100
0000011111111111111111111111111111111000001111111111111100000111111111111111111111111111111111111100
0000111111111111111111111111111111110000001111111111111110000111111111111111111111111111111111111100
0001111111111111111111111111111111110000011111111111111111000111111111111111111111111111111111111100
0011111111111111111111111111111111111000111111111111111111100111111111111111111111111111111111111100
0011111111111111111111111111111111111111111111111111111111100111111111111111111111111111111111111100
0011111111111111111111111111111111111111111111111111111111100011111111111111111111111111111111111100
0011111111111111111111111111111111111111111111111111111111110001111111111111111111111111111111111100
0011111111111111111111111111111111111111111111111111111111110000111111111111111111111111111111111100
0011111111111111111111111111111111001111111111111111111111111000011111111111111111111111111111111100
0011111111111111111111111111111110000111111111111111111111111000001111111111111111111111111111111100
0001111111111111111111111111111100000111111111111111111111111100000111111111111111111111111111111100
0001111111111111111111111111111000001111111111111111111111111110000111111111111111111111001111111100
0001111111111111111111111111110000001111111111111111111111111110000111111111111111111110000111111100
0000111111111111111111111111110000011111111111111111111111111110000111111111111111111110000111111100
0000111111111111111111111111111000111111111111111111111111111110000111111111111111100111001111111100
0000011111111111111111111111111111111111111111111111111111111111001111111111111111000011111111111000
0000011111111111111111111111111111111111111111111111111111111111111111111111111111000011111111111000
0000111111111111111111111111111111111111111111111111111111111111111111111111111111100111111111111000
0000111111111111111111111111111111111111111111111111111111111111111111111111111111111111111111111100
0000111111111111111111111111111111111111111111111111111111111111111111111111111111111111111111111100
0000111111111111111111111111111111111111111111111111111111111111111111111111111111111111111111111100
0001111111111111111111111111111111111111111111111111111111111111111111111111111111111111111111111100
0001111111111111111111111111111111111111111111111111111111111111111111111111111111111111111111111000
0001111111111111111111111111111111110011111111111111111111111111111111111111111111111111111111111000
0001111111000011111111111111111111100001111111111111111111111111111111111111111111111111111111111100
0000111110000001111111111111111111000001111111111111111111111111111111111111111111001111111111111110
0000111110000000111111111111111111000011111111111111111111111100111111111111111110000111111111111110
0000111110000000011111111111111111100111111111111111111111111000011111111111111110000000011111111110
0000011110000000001111111111111111111111111111111111111111111000011111111111111110000000001111111110
0000001111000000000111111111111111111111111111111111111111111100001111111111111111000000001111111110
0000000111000000000111111111111111111111111111111111111111111110001111111111111111100000000111111100
0000000111000000000111111111111111111111111111111111111111111111001111111111111111110000000011111100
0000001111000000000111111111111111111111111111111111111111111111001111111111111111110000000001111100
0000111111000000000111111111111111111111111111111111111111111110001111111111111111111000000000111100
0001111111100000000111111111111111111111111111111111111111111100000111111111111111111100000000111100
0011111111100000000011111111111111111111111111111111111111111000000011111111111111111110000000111110
0011111111110000000011111111111111111111111111111111111111111000000001111111111111111111000000111110
0001111111111000000001111111111111111111111111111111111111111000000000001111111111111111000000011100
0000111111111100000001111111111111111111111111111111111111111100000000000011111111111111100000000000
0000011111111110000000111111111111111111111111111111111111111111111000000001111111111111110000000000
0000011111111111000000011111111111111111111111111111111111111111111100000000111111111111111000000000
0000011111111111100000011111111111111111111111111111111111111111111110000000111110011111111000000000
0000011111111111110000011111111111111111111111111111111111111111111111000000111100001111110000000000
0000111111111111110000001111111111111111111111111111111111111111111111100000111100000111100000000000
0001111111111111110000000111111111111111111111111111111111111111111111100000111100000111100000000000
0011111111111111110000000011111100111111111111111111111111111001111111100000011000000111110000000000
0011111111111111110000000011111000011111111111111111111111110000111111000000011000000111111000000000
0001111111111111100000000011110000011111111111111111111111110000111110000000001000000111111100000000
0000111111111111100000000011110000011111111111111111111111111001111110000000001100001111111100000000
0000011111111111110000000001100000001111111111111111111111111111111110000000001110001111111110001100
0000011111111111111111000000000000001111111111111111111111111111111100000000001110000111111111111110
0000011111111111111111100000000000001111111111111111111111111111111000000000001111000000011111111110
0000011111111111111111110000000000000111111111111111111111111111111000000000001111100000001111111100
0000111111111111111111111000000000000111111111111111111111111111111000000000011111100000000111111100
0000111111111111111111111111000000000111111111111111111111111111111000000000111111100000000111111100
0001111111111111111111111111100000000111111111111111111111111111111000000000111111100000001111111110
0011111111111111111111111111110000000011111111111111111111111111111100000000111111100000001111111110
0111111111111111111111111111111100000011111111111111111111111111111110000000111111100000011111111110
0111111111111111111111111111111110000011111111111111111111111111111111000000111111100000011111111110
0011111111111111111111111111111110000001111111111000111111111001111111000000111111100000001111111110
0001111111111111111111111111111110000000011111110000011111110000011110000000011111000000000011111100
0000111111111111111001111100001100000000000000000000000011000000000000000000000000000000000001110000
0000000000000000000000000000000000000000000000000000000000000000000000000000000000000000000000000000
