0000000000000000000000000000000000000000000000000000000000000000000000000000000000000000000000000000
0000000000000000000000011111100000000000000000000000000000000000000000000000000000000000000000000000
0000000000000000000000111111110000000000000000000000000000000000000000000000000000000000000000000000
0000000000000000000000111111110000000000000000000011111100000000000000000000000000000000000000000000
0000000000000000000000111111100000000000000000011111111110000000000000000000000000000000000000000000
0000000000011000000000111111100000000000000000111111111111000000000000000000000000000000000000000000
0000000000111100000000111111110000000000000000111111111111100000000000000000000000000000000000000000
0000000000111110000000011111110000000000000000011111111111100000000000000000000000000000000000000000
0000000000011111000000001111110000000000000000000000111111100000000000000000000000000000000000000000
0000000000011111100000000001110000000000000000000000011111100000000000000000001110000000000000000000
0000000000111111100000110000111000000000000000000000011111100000000011000000011111000000000011000000
0000000000111111100001111000111100000000000000000000011111100000000111100000111111110000000111100000
0000000000111111100001111000111110000000000000000000011111110000000111100000111111111000000111110000
0000000000011111100000110000011111000000000000000000001111111000001111100000011000111100000111110000
0000000000001111100000000000011111100000000000110000001111111111111111100000000000011100000011110000
0000000000000111000000000000111111110000000001111000011111111111111111110000000000011110000001110000
0000000000000110000000000001111111111100000001111111111111111111111111110000000000011111000001111000
0000001100000110000000000001111111111110000011111111111111111111111111111000000000011111100001111100
0000011110000110000000000001111111111111000111111111001111111111111111111110000000011111110011111100
0000111111000011000000000001111111111111111111111110000111111111111111111111000000111111111111111100
0001111111100001111111100001111111111111111111111100000011111111111111111111111111111111111111111100
0001111111100001111111110011111111111111111111111100000011111111111111111111111111111111111111111110
0001111111100001111111111111111111111111111111111110000111111111111111111111111111111111111111111110
0001111111000011111111111111111111111111111111111111001111111111111111111111111111111111111111111100
0001111110000011111111111111111111111111111111111111111111111111111111111111111111111111111111111100
0001111110000001111111111111111111111111111111111111111111111111111111111111111111111111111111111100
0001111111000000111111000001111111111111111111111111111111111111111111111111111111110011111111111100
0001111111100000111110000000111111111111111111111111111111111111111111111111111110000001111111111110
0000111111110000111110000000011111111111111111111111111001111111111111111111111100000000111111111110
0000111111111001111110000000011111111111111111111111000000111111111111111111111100000000011111111110
0001111111111111111100000000011111111111111111111110000000111111111111111111111110000000000111111100
0001111111111111111000000000011111111111111111111110000000011111111111111111111110000000000011111100
0000111111111111111000000000011111111111111111111110000000001111111111111111111110000000000011111110
0000111111111111111100000000001111111111111111111110000000001111111111111111111110000000000111111110
0001111111111111111110000000000001111111111111111110000000001111111111111111111110000000000111111100
0011111111111111111111000000000000000011111111111100000000000111111111111111111110000000000111111000
0011111111111111111111110000000000000001111111111000000000000011111111111111111111000000000111111000
0011111111111111111111111000000000000000111111000000000000000001111111111111111111000000000111111000
0001111111111111111001111100000000000000011110000000000000000001111111111111111111000000000111111000
0000111111111111110000111111000000000000011110000000000000000000111111111111111111000000000111111000
0000011111111111100000111111100000000000111110000000000000000000111111111111111111100000000011111000
0000001111111110000000111111110000000000111110000000000000000000011111111111111111111111000011111000
0000001111111100000001111111111100000000111111000000000000000000001111111111111111111111100001111000
0000011111111000000111111111111110000000111111000000000000000000001111111111111111111111100000110000
0000111111111000001111111111111110000000111111000000000000000000001111111111111111111111100000000000
0000111111111000001111111111111110000000111111000001110000000000001111111111111111111111100000000000
0000111111111100001111111111111111000000111111100011111000000000000111111111111111111111000000000000
0000111111111110001111111111111111100000111111111111111000000000000011111111111111111110000000000000
0000111111111111000111111111111111100000111111111111111000000000000011111111111111111110000000000000
0000111111111111000011111111111111100000011111111111111100000000000111111111111111111111000000000000
0000111111111111000001111111111111100000001111111111111110000000001111111111111111111111100000000000
0001111111111111000000111111111111100000000011111111111111000000011111111111111111111111100000000000
0001111111111111100000111111111111100000000001111111111111100000011111111111111111111111100000000000
0001111111111111111001111111111111110000000000111111111111100000011111111111111111111111100000000000
0000111111111111111111111111111111110000000000011111111111000000011111111111111111111111110000000000
0000111111111111111111111111111111110000000000011111111111000000011111111111111111111111110000000000
0000111111111111111111111111111111111000000000011111111111100000011111111111111111111111110000000000
0000111111111111111111111111111111111100000000011111111111100000001111111111111111111111111000000000
0000111111111111100111111111111111111111110000001111111111100000001111111111111111111111111111000000
0000111111111111000011111111111111111111111000001111111111100000001111111111111111111111111111100000
0000111111111110000001111111111111111111111100011111111111110000001111111111111111111111111111111000
0000011111111110000001111111111111111111111111111111111111111000001111111111111111111111111111111100
0000001111111111000011111111111111111111111111111111111111111100000111111111111111111111111111111100
0000000111111111100011110011111111111111100111111111111111111110000011111111111111111111111111111110
0000000011111111100001100001111111111111000011111111111111111111000001111111111111111111111111111110
0000000001111111100000000000110001111111000011111111111111111111100001111111111111111111111111111110
0000000000111111100000000000000000111111000001111111111111111111110011111111111111111111111111111100
0000000000011111110000000000000000111110000000001111111111111111111111111111111111111111111111111100
0000000000001111111000000000000000111100000000000111111111111111111111111111111111111111111111111100
0000000000001111111100000000000000011000000000000011111111111111111111111111111111111111111111111100
0000000000000111111100000000000000000000000000000001111111111111111111111111111111111111111111111100
0000000000000111111110000000000000000000000000000001111111111111111111111111111111111111111111111100
0000000000000111111111000000000000000000000000000001111111111111111111111111111111111111111111111100
0000000000000111111111110000000000000000000000000001111111111111111111111111111111111111111111111000
0000000000000111111111111000000000000000000000000011111111111111111111111111111111111111111111110000
0000000000000111111111111111000000000000000000011111111111111111111111111111111111111111111110000000
0000000000000111111111111111100000000000000000111111111111111111111111111111111111111111111100000000
0000000000000011111111111111100000000000000000111111111111111111111111111111111111111111111100000000
0000011000000011111111111111100000000000000000011111111111111111111111111111111111111111111110000000
0000111100000011111111111111100000000000000000001111111111111111111111111111111111111111111111000000
0001111110000001111111111111110000000000000000001111111111111111111111111111111111111111111111100000
0001111111000000111111111111110000000000000000000111111111111111111111111111111111111111111111100000
0001111111110000011111111111110000000000000000000111111111111111111111111111111111111111111111110000
0000111111111000001111111111110000000000000000000111111111111111111111111111111111111111111111111000
0000111111111000000111111111100000000000000000000011111111111111111111111111111111111111111111111000
0001111111111100000011111111100000001100000000000001111111111111111111111111111111111111111111111000
0011111111111110000001111111110000011111100000000000111111111111111111111111111111111111111111111100
0111111111111111000000111111111000011111110000000000111111111111111111111111111111111111111111111100
0111111111111111000000111111111100011111110000011001111111111111111111111111111111111111111111111000
0111111111111111000000111111111100011111110000111111111111111111111111111111111111111111111111110000
0011111111111111100000011111111111111111111001111111111111111111111111111111111111111111111111100000
0011111111111111110000011111111111111111111111111111111111111111111111111111111111111111111111100000
0111111111111111111000001111111111111111111111111111111111111111111111111111111111111111111111110000
0111111111111111111000000011111111111111111111111111111111111111111111111111111111111111111111111000
0111111111111111111100000000011111111111111111111111111111111111111111111111111111111111111111111000
0111111111111111111100000000001111111111111111111111111111111111111111111111111111111111111100110000
0011111111111111111000000000001111110001111111111111111111111111111111111111111111111111111000000000
0011111111111111110000000000001111100000111111111111111111111111111111111111111111111001111000000000
0001111111111100000000000000000111000000011000001111111111111111110000011000000001110000110000000000
0000000000000000000000000000000000000000000000000000000000000000000000000000000000000000000000000000
