0000000000000000000000000000000000000000000000000000000000000000000000000000000000000000000000000000
0000000000000000000000000000001110000000000000000000000000000000000000000000000000000000000000000000
0000000000000000000000000000011111000000000000000000000111000000000000000011100000000000000000000000
0000000000000000000000000000111111000000000000000000001111100001100000000111110000000000000000000000
0000000000000000000000000000111111100000000000000000001111110011111000000111111000000000000000000000
0000000000000000000000000000011111100000000000000000001111111111111100001111111000000000000111000000
0000000000000000000000000000001111100000000000000000001111111111111110011111111000000000001111110000
0000000000000000000000000000000111000000000000000000001111111111111111111111111100000000001111111000
0000000000000000000000000000000000000000011000000000000111111111111111111111111110000000001111111000
0000000000000000000000000000000000000000111100000000000111111111111111111111111110000000001111111000
0000000110000111000000000000000000000001111110000000001111111111111111111111111110000000001111111000
0000001111001111100000000000000000000001111111001110001111111000111111111111111111000000001111111000
0000011111111111111110000000000000000000111111111111000111110000011111111111111111100000011111111000
0000011111111111111111000000000000000000111111111111100011110000011111111111111111110011111111111100
0000011111111111111111000000000110000000111111111111100001110000111111111111111111111111111111111100
0000001111111111001110000000001111000000111111111111100000111000111111111111111111111111111111111100
0000000111111110000000000000001111000000111111111111100000111000111111111111111111111111111111111100
0000000111111110000000000000011111000000011111111111100000110000111111111111111111111111111111111100
0000001111111111000000000000011111000000011111111111000000110001111111111111111111111111111111111100
0000111111111111100000000000011111100000011111111110000001111001111111111111111111111111111111111100
0001111111111111110000000000001111110000011111100000000001111001111111111111111111111111111111111100
0001111111111111111000000000000111111000001111000000000000110000111111111111111111111111111111111100
0001111111111111111000000000000111111100000111000001100000000000011111111111111111111111111111111100
0001111111111111111000000000000111111100000011100011110000000000001111111111111111111111111111111100
0000111111111111111000000000000011111100000011111111111000000000001111111111111111111111111111111100
0000011111111111111000000000000000111100000001111111111100000000001111111111111111111111111111111110
0000000011111111110000000000000000011100000000111111111100000000001111111111100011111111111111111110
0000000001111111110000000000000000011000000000011111111100000000011111111111000001111111111111111100
0000000001111111110000000000000000111000011000001111111110000000111111111111000001111111111111111000
0000000001111111111000000000000000111100111100001111111110000001111111111111100000111111111111111000
0000000001111111111000111110000000111111111100011111111111000001111111111111100000011111111111111000
0000000011111111110001111111000000111111111110011111111111100011111111111111100000011111111111111000
0000000111111111100011111111100001111111111111001111111111111111111111111111100000011111111111111000
0000111111111111100111111111100001111111111111000111111111111111111111111111110000011111111111111000
0001111111111111100111111111100000111111111110000111111111111111111111111111111000011111111111110000
0001111111111111000011111111100000011111111110000111111111111111111111111111111100111111111111110000
0001111111111110000001111111100000001111111111001111111111111111111111111111111111111111111111111000
0001111111111110000000111111110000001111111111111111111111111111111111111111111111111111111111111100
0011111111111111000000111111111000001111111111111111111111111111111111111111111111111111111111111100
0011111111111111000000111111111100001111111111111111111111111111111111111111111111111111111111111100
0001111111111111000001111111111100000111111111111111111111111111111111111111111111111111111111111100
0001111111111111000011111111111100000011111111111111111111111111111111111111111111111111111111111100
0001111111111111100111111111111000000001111111111111111111111111111111111111111111111111111111111100
0001111111111111111111111111111000000001111111111111111111111111111111111111111111111111111111111100
0001111111111111111111111111111100000000111111111111111111111111111111111110001111111111111111111110
0000111111111111111111111111111100000000011111111111111111111111111111111100000111111111111111111110
0000011110011111111111111111111000011000011111111111111111001111000111111100000011111111111111111110
0000000000001111111111111111111000111100001111111111111100000110000011111100000011111111111111111100
0000000000000111111111111111111100111110001111111111111000000000000011111100000011111111111111111100
0000000000000011111111111111111100111111000111111111111000000000000111111000000111111111111111111100
0000000000000011111111111111111000011111100111111111111100000000000110000000001111111111111111111100
0000000000000001111000111111111000001111100011111111111100000000001100000000001111111111111111111000
0000000000000001110000011111111100000111000001111111111100000000011100000000001111111111111111110000
0000000000000011100000001111111100000000000001111111111100000111111110000000001111111111111111100000
0000000000000111100000001111111110000000000001111111111110001111111110000000000111111111111111100000
0000000000001111110000011111111111000000000011111111111111111111111111000000000011111111111111100000
0000000000001111110000011111111111100000000011111111111111111111111111100000000011111110011111110000
0000000000001111110000111111111111100000000001111111111111111111111111110000000011111100001111110000
0000000000001111111001111111111111110000000001111111111111111111111111111000000001111100001111110000
0000000000001111111111111111111111110000000000111111111111111111111111111100000000111110011111110000
0000000000011111111111111111111111111000000000011111111111111111111111111110000000111111111111111000
0000000001111111111111111111111111111100000000011111111111111111111111111111110000011111111111111100
0000000011111111111111111111111111111110000000011111111001111111111111111111111000000111111111111100
0000000011111111111111111100111111111111000000011111110000111111111111111111111000000011111111111100
0000000011111111111111111000011111111111000000011111110000011111111111111111111100000011111111111100
0000000011111111111111111000001111111111100000011111111000001111111111111111111111000001111111111100
0000000111111111111111111100001111111111100000001111111100000111111111111111111111100000111111111100
0000111111111111111111111110001111111111000000001111111110000011111111111111111111110000011111111100
0001111111111111111111111110000111111111000000001111111111000001111111111111111111111000001111111100
0001111111111111111111111110000011111111000000011111111111100000111111111111111111111000001111111100
0011111111111111111111111111000001111111000111111111111111110000011111111111111111111100000111111000
0111111111111111111111111111100000111111001111111111111111110000011111111111111111111110000011110000
0111111111111111111111111111100000001110001111111111111111111000011111111111111111111111000011100000
0111111111111110001111111111100000000000000111111111111111111100001111111111111111111111100111100000
0011111111111100000111111111110000000000000111111111111111111100000001111111111111111111111111110000
0001111111111100000111111111111100000000000111111111111111111110000000111111111111111111111111111000
0000111111111100000011111111111110000000001111111111111111111110000000011111111111111111111111111100
0000111111111110000001111100011111000110011111111111111111111110000000011111111111111111111111111100
0000011111111111000000000000001111111111111111111111111111111111000000111111111111111111111111111110
0000001111111111000000000000001111111111111111111111111111111111100000111111111111111111111111111110
0000000111111111000000000000001111111111111111111111111111111111110000111111111111111111111111111100
0000000111111111000000000000000111111111111111111111111111111111111000111111111111111111100001111100
0000000111111111000000000000000111111111111111111111111111111111111000011111111111111111000000111100
0000001111111111100000000000000011111111111111111111111111111111111000001111111111111111000000111100
0000011111111111111000000000000001111111111111111100111111111111111000000111111111111111100000111100
0000011111111111111110000000000001111111111111111000011111111111111000000011111111111111110000011000
0000001111111111111111000000000001111111111111110000001111111111111000000011111111111111111110000000
0000001111111111111111000000000001111111111111100000001111111111111100000111111111111111111111000000
0000001111111111111111100000000011111111111111000000001111111111111100000111111111111111111111000000
0000001111111111111111110000000011111111111110000000001111100111111110000011111111111111111110000000
0000000111111111111111111000000011111111111110000000001111000011111111000011111111111111111110000000
0000000111111111111111111111000001111111111110000000000111000011111111100111111111111111111110000000
0000000111111111111111111111100001111111111100000000000011100111111111111111111111111111111110000000
0000000111111111111111111111110001111111111100000000000001111111100111111111111111111111111100000000
0000000111111111100111111111110000111111111100000000000001111111000011111111111111111111111000000000
0000000111111111000011111111100000011111111110000011110011111110000011111111111111111111111000000000
0000000111111111000001111110000000001111111111001111111111111110000011111111111111111111111100000000
0000000011111111000000111100000000000001111111111111111111111100000001111111111111111111111100000000
0000000001111110000000000000000000000000111111110011000000000000000000000001111001100000111000000000
0000000000000000000000000000000000000000000000000000000000000000000000000000000000000000000000000000
