0000000000000000000000000000000000000000000000000000000000000000000000000000000000000000000000000000
0000000000000000000000000000000000000000000000000000000000000000000000000000000000000000000000000000
0000000000000000000000000000000000000000000000000000001100000000000000000000000000000000000000000000
0000000000000000000000000000000000000000000000000000011110001100000000000000000000000000000000000000
0000000000000000000000001100000000000000000000000000011111111110000001111000000000000000000000000000
0000000000000000000000011110000000000000000000000000011111111111000011111100000000000000000000000000
0000000000000000000000011110000000000000000000000000011111111111100111111100001100000000000000000000
0000000000000000000000011110000000000000000111110000011111111111111111111110011110000000000000001100
0000000000000000000000001111000000000000001111111000011111111111111111111111111110000000000000011110
0000000000110000000000000111100000000000011111111100111111111111111111111111111111000000000000011110
0000000001111000000110000111100000000011111111111111111111111111111111111111111111100000000000111110
0000000011111100001111001111110000000111111111111111111111111111111111111111111111100000000001111110
0000011111111110011111111111111000001111111111111111111111111111111111111111111111100000000011111100
0000111111111111111111111111111100001111111111111111111111111111111111111111111111110000000011111000
0000111111111111111111111111111111001111111111111111111111111111111111111111111111110000000001110000
0000111111111111111111111111111111100111111111111111111111111111111111111111111111110000000000000000
0001111111111111111100111111111111100011111111111111111111111111111100011111111111110000000000000000
0011111111111111111000011111111111100001111111111111111111111111111000000000000111110000000000000000
0011111111111111111000001111111111100000111111111111100111111111111000000000000011110000000000000000
0011111111111111110000001111001111100000111111111111000011111111111100000000000011111000000000000000
0011111111111111110000011110000111100000111111111110000001111111111110000000000001111000110000000000
0011111111111111110000011110000111100000011111111110000001111111111111000000000001111001111000000000
0001111111111111111000001100000111100000000111111111000000111111111111111110000000110001111000000000
0000111111111111111100000000000111110000000011111111100000011111111111111111100000000000111100000000
0000011111111111111110000000000111111000000001111111110000011111111111111111110000000000011110000000
0000011111111111111110000000000011111100000000111111111000111111111111111111110000000000001111000000
0000011111111111111110000000000011111110000000111111111111111111111111111111100000000000001111100000
0000011111111111111110000000000111111111000000111111111111111111111111111111000000000000001111110000
0000011111111111111111000000001111111111100000111111111111111111111111100110000000000000011111111000
0000111111111111111111000000001111111111110000011111111111111111111111000000000000000000011111111100
0000111111111111111111100110011111111111110000011111111111111111111111000000000000011000111111111100
0000111111111111111111111111111111111111100000011111111111111111111111100000000000111111111111111110
0000011111111111111111111111111111111111000000001111111111111111111111111100000001111111111111111110
0000011111111111111111111111111111111110000000001111111111111111111111111110000011111111111111111110
0000111111111111111111111111111111111110000000001111111111111111111111111110000011111111111111111100
0001111111111111111111111111111111111111000000011111111111111111111111111110000011111111111111111100
0001111111111111111111111111111111111111100000011111111111111111111111111110000001111111111111111100
0011111111111111111111111111111111111111110000011111111111111111111111111111000000111111111111111100
0011111111111111111111111111111111111111111000011111111111111111111111111111111001111111111111111100
0011111111111111111111111111111111111111111000011111111111111111111111111111111111111111111111111100
0001111111111111111111111111111111111111111000001111111111111111111111111111111111111111111111111110
0001111111111111111111111111111111111111110000000111111111111111111111111111111111111111111111111110
0000111111111111111111111111111111111111110000000111111111111111111111111111111111111111111111111110
0000111111111111111111111111111111111111100000000011111111111111111111111111111111111111111111111110
0000111111111111111111111111111111111111100000000011111111111111111111111111111111111111111111111100
0000011111111111111111111111111110001111100000000001111111101111111111111111111111111111111111111000
0000001111111111111111111111111100000111110000000000111111000111111111111111111111111111111111111000
0000001111111111111111111111111100000111111100000000011111000111111111111111111111111111000111111000
0000011111111111111111111111111110001111111110000000011111000111111111111111111111111110000011111100
0000011111111111111111111111111111111111111111000000001111000011111111111111111111110000000011111110
0000011111111111111111111111111111111111111111100000001111000011111111111111111111100000000011111110
0000001111111111111111111111111111111111111111110000011111000001111111111111111111100000000111111110
0000000111111111111111111111111111111111111111111111111111000001111111111111111111110000000111111110
0000000011111111100011111111111111111111111111111111111111100000111111111111111111111110000011111100
0000000011111111000001111111111111111111111111111111111111110000111111111111111111111111000011111100
0000000011111111000001111111111111111111111111111111111111111000011111111111111111111111100111111100
0000000011111111000001111111100111111111111111111111111111111100001111111111111111111111111111111100
0000000011111111100001111111000011111111110000111111111111111100000111111111111111111111111111111100
0000000001111111100001111110000001111111100000001111111111111100000111111111111111111111111111111100
0000000001111111100001111100000001111111100000000111111111111100001111111111111111111111111111111100
0000000001111111110001111100000011111111100000000111111111111100011111111111111111111111111111111100
0000000000111111111001111100000111111111000000001111111110011000011111111111111111111111111111111100
0000000000011111111000111000001111111111000000001111111100000000011111111111111111111111111111111100
0000000000011111111100000000011111111111000000000111111100000000011111111111111111111111111111111000
0000000000011111111110000000011111111111000000000011111100000000111111111111111111111111111111111000
0000000000001111111111000000001111111111100000000011111100000001111111111111111111111111111111111000
0000000000000111111111000000001111111111111100000011111100001111111111111111111111111111111111111000
0000000000000011111111000000001111111111111110000111111110011111111111111111111111111111111111111100
0000000000000011111111100000000111111111111111000111111111111111111111111111111111111111111111111100
0000000000000011111111110000000111111111111111000111111111111111111111111111111111111111111111111100
0000000000000111111111111000000111111111111111000111111111111111111111111111001111111111111111111100
0000000000000111111111111000000111111111111110000111111111111111111111111110000111111111111111111000
0000000000001111111111111000000111111111111110000111111111111111111111111110000111111111111100000000
0000000000011111111111111000000111111111111111000011111111111111111111111100000111111111111000000000
0000000000111111111111111000000011111111111111100001111111111111111111111100001111111111111000000000
0000000000111111111111110000000001111111111111100001111111111111111111111110011111100111111100000000
0000000000111111111111110000000000111111111111100001111111111111111111111111111111000011111110000000
0000000000011111111111100000000000001111111111110011111111111111111111111111111111000001111110000000
0000000000011111111100000000000000000111111111111111111111111111111111111111111111100000111111000000
0001100000011111111000000000000000000111111111111111111111111111111111111111111111100000111111100000
0011110000011111111000000000000000000011111111111111111111111111111111111111111111110000011001100000
0011110000001111111000000000000000000001111111111111111111111111111111111111111111110000000000100000
0011110000001111110000000000000000000001111111111111111111111111111111111111111111100000000000110000
0001110000000111100000000000000000000001111111111111111111111111111111111111111111100000000000111000
0001110000000000000000000000000000000000111111111111111111111111111111111111111111100000000000011100
0001110000000000000000011000000000000000011111111111111111111111111111111111111111110000000000001110
0001111000000000000000111100000000000000001111111111111111111111111111111111111111111110000000001110
0001111111111000000001111100000000000000001111111111111111111111111111111111111111111111000000011110
0001111111111100001111111100000000000000011111111111111111111111111111111111111111111111000000111110
0000111111111100011111111100000000000000011111111111111111111111111111111111111111111111000000111110
0000111111111100011111111100000001100000011111111111111111111111111111111111111111111110000000011110
0000111111111000011111111110000011111000011111111111111111111111111111111111111111111100000000001110
0000111111111000011111111110000111111100011111111111111111111111111111111111111111111000000000001100
0001111111111000011111111110001111111100011111111111111111111111111111111111111111111000000000000000
0001111111111000011111111110001111111000001111111111111111111111111111111111111111111000000000000000
0000111111111100111111111110001111110000001111111111111111111111100011111111111111111100000000000000
0000011100111111111111111110001111110000001111111111111111111111000001111111111111111100000000000000
0000000000011111111111111110000111100000001111111111000111001110000000111111111111111000000000000000
0000000000000111100000011100000000000000000111111110000000000000000000000001111111110000000000000000
0000000000000000000000000000000000000000000000000000000000000000000000000000000000000000000000000000
