0000000000000000000000000000000000000000000000000000000000000000000000000000000000000000000000000000
0000000000000000000000000000000000000110000000000000000000000000000000000000000000000000000000000000
0000000000000000000000000000000000001111000000000000000000000000000000000000000000000000000000000000
0000000000000000000000000000000000011111100000000000000000000000000000000000000000000000000000000000
0000000000001111000000000000000000111111110000000000000000000000000000000000000000111100000000000000
0001100000011111100000000000000000111111111110000000000000000000000000000000000001111110000000000000
0011111100111111100000000000000000111111111111100000000000000110000111000000000001111111111000000000
0011111111111111110000000000000000011111111111110000000000111111001111100000000001111111111100000000
0011111111111111111000000000000000001111111111111000000001111111111111110000000001111111111110000000
0111111111111111111100000000000011000111111111111100000011111111111111111000000011111111111111000000
0111111111111111111100000011000111100001111111111110000111111111111111111100000011111111111111100000
0011111111111111111100000111100111100000111111111110000111111111111111111100000001111111111111100000
0011111111111111111110000111100011100000111111111110000111111111111111111100000000001111111111100000
0011111111111111111111001111100011110000111111111111000111111111111111111000000000000000011111000000
0011111111111111111111111111110001111000111111111111000111111111111111111000000000000000001111000000
0011111111111111111111111111111001111100011111111111000111111111111111111000000000000000001111100000
0011111111111111111111111111111001111100001111001110000011111111111111111100000000000000011111111000
0001110001111111111111111111110001111000001110000000000001111111111111111110000000000000111111111100
0000000000111111111111111111100001111000001100000000000000111111111111111110000001110001111100111100
0000000000111111111111111111100000111100001100000000000000011111111111111110000011111111111000011000
0000000000111111111111111111110000111100001110000000000000011111111111111100000111111111111000000000
0000000000011111111111111111111001111000001110000000000000011111111111100000000111111111111100000000
0000000000001111111111111111111111110000011111000000000000111111111111000000000111111111111110000000
0000000000000111111111111111111111110000111111100000000000111111111111000000001111111111111110000000
0000000000000011100111111111111111110000111111100000000000111111111111000000001111111111111111000000
0000000000000000000011111111111111111000111111000000000000011111111111000000000111111111111111000000
0000000000000000000011111111111111111101111111000000000000011111111110000000000000011111111111100000
0000000000000000000011111111111111111111111111000000000000001111111100000000000000001111111111111000
0000000000000000000111111110011111111111111110000000000000001111111100000000000000000111111111111100
0000000000000001111111111100001111111111111110000000000000011111111100000000000000000011111111111110
0000000000000011111111111100001111111111111111000000000000111111111100000000000000000011111111111110
0000000000001111111111111110011111111111111111100000000000111111111100000000000000000001111111111110
0000000000011111111111111111111111111111111111100000000000011111111110000000000000000000001111111100
0000000000011111111111111111111111111111111111100000000000001111111111100000000000000000000111111000
0000000000011111111111111111111111111111111111110000000000000111111111110000000000000000000011111000
0000000000011111111111111111111111111111111111111100000000000111111111110000000000000000000001111100
0000000000111111111111111111111111111111111111111110000000001111111111100000000000110000000001111100
0000000111111111111111111111111111111111111111111111000000011111111111100000000001111001110011111100
0000011111111111111111111111111111111111111111111111100000111111111111110000000001111111111111111100
0000111111111111111111111111111111111111111111111111110000111111111111111000000000111111111111111100
0000111111111111111111111111111111111111111111001111111000111111111111111100000000011111111111111000
0000011111111111111111111111111111111111111110000111111000111111111111111100000000011111111111111000
0000001111111111111111111111111111111111111100000111110000111111111111111000000000011111111111111100
0000001111111111111111111111111111111111111000000111100000111111111111110000000000111111111111111100
0000001111111111111111111111111111111111111000000111000000111111111111100000000001111111111111111100
0000000111111111111111111111111111111111111000000111000000011111100110000000000011111111111111111100
0000000111111111111111111111111111111111111100000011100000011111000000000000000111111111111111111100
0000000111111111111111111111111111111111111100000001100000111111000000000000001111111111111111111000
0000000011111111111111111111111111111111111100000000000000111111100000000000001111111111111111110000
0000000001111111111111111111111111111111111100000000000000111111110000000000000111111111111111110000
0000000000000011111111111111111100001111111100000000000000111111111000000000000111111111111111111000
0000000000000001111111111111111000000001111110000000000000111111111100000000000111111111111111111000
0000000000000000111111111111111000000000111111110000000000111111111110000000000111111111111111111000
0000000000000000011111111111111000000000111111111000000000011111111111000000000011111111111111111000
0000000000000000011111111111111000000000111111111000000000011111111111100000000000111111111111111100
0000000000000000001111111111111000000000011111110000000000011111111111111100000000000111111111111100
0000000000000000000111111111111100000000011111100000000000011111111111111110000000000011111111111100
0000000000000000000111111111111111000000111111100000000000001111111111111111000000000001111111111100
0000000000000000000111111111111111100000111111100000000000001111111111111111000000000001111111111100
0000000000000000000011111111111111110000011111000000000000001111111111111111000000000011111111111000
0000000000000000000000001100111111111000000000000000011100001111111111111111100000000111111111110000
0000000000000000000000000000011111111100000000000000111110011111111111111111100000000111111111110000
0000000000000000000000000000011111111110000000000000111111111111111111111111100011001111111111110000
0000000000000000000000000000111111111110000000000000011111111111111111111111000111111111111111111000
0000000000000000000000000111111111111110000000000000011111111111111111111110000111111111111111111100
0000000000000000000000001111111111111110000000000000011111111111111111111100000111111111111111111100
0000000000000000000000011111111111111111000000000000001111111111111111111000000111111111111111111100
0000000000000000000000011111111111111111000000000000000001111111111111110000001111111111111111111100
0000000000000000000000001111111111111111000000000000000000111111111111000000001111111111111111111100
0000000000000000000000000111111111111111000000000000000000001111110000000000001111111111111111111100
0000000000000000000000000111111111111111100000000000000000000111000000000000000111111111111111111100
0000000000000000000000000011111111111111110011100000000000000000000000000000000011111111111111111100
0000000000000000000000000011111111111111111111110000000000000000000000000000000001111111111111111100
0000000000000000000000000011111111111111111111111000000011111000000000000000000000111111111111111100
0000000000000000000000000001111111111111111111111100000111111100000000000000000000111111111111111100
0000000000000000000000000000111111111111111111111100001111111111100000000000000001111111111111111100
0000000000000000000000000000011111111111111111111100001111111111111100000000000111111111111111111100
0000000000000000000000000000011111111111111111111100001111111111111110000000001111111111111111111100
0000000000000000000000000000001111111111111111111110011111111111111110000000001111111111111111111100
0000000000000000000000000011000011111111111111111111111111111111001111000000011111111111111111111100
0000000000000000000000000111100001111111111111111111111111111110000111100000111111111111111111111100
0000000000000000000000000111100001111111111111111111111111111110000011110000111111111111111111111100
0000000000000000000000001111110011111111111111111111111111111110000001110000011111111111111111111110
0000000000000000000000001111111111111111111111111111111111111110000001111000001111111111111111111110
0000111000000000000000001111111111111111111111111111111111111110000001111000001111111111111111111100
0001111100000000000000011111111111111111111111111111111111111111000011111000001111111111111111111100
0001111111000000000000111111111111111111111111111111111111111111111111111000001111111111111111111100
0001111111100000000001111111111111111111111111111111111111111111111111111000011111111111111111111100
0000111111100000000001111111111111111111111111111111111111111111111111111100111111111111111111111100
0000111111100000000000111111111111111111111111111111111111111111111111111111111111111111111111111100
0000111111100000000000111111111111111111110011111111111111111111111111111111111111111111111111111100
0000111111100000000000011111111111111111100001111111111111111111111111111111111111111111111111111110
0000011111100000000000011111111111111111100001111111111111111111111111111111111111111111111111111110
0000001111110000000000011111111111111111110011111111111111111111111111111111111111111111000111111100
0000000111111000000000001111111111111111111111111111111111111111111111111111111111111110000011111100
0000000111111100000000000111111111111111111111111111111111111111111111111111111111111110000011111100
0000000111111100000000000001111111111111111111111111111111111111111001111111111111111100000111111100
0000000011111000000000000000111111111110000111111111111111111111110000111111111100111100000111111000
0000000001100000000000000000000000001100000011111111111111111111100000011111111000011000000011100000
0000000000000000000000000000000000000000000000000000000000000000000000000000000000000000000000000000
