0000000000000000000000000000000000000000000000000000000000000000000000000000000000000000000000000000
0000000000000000000000011000000000000000000000000000000000000000000000000000000000000000000000000000
0000000000000000000001111100000000000000000000000000000000000000000000000001110000000000000001111000
0000000000000000000011111110000000000000000000000000000011000000000000000011111000000000000011111100
0000000001100000000011111111000000000000000000000000000111100000000001100111111100000000000111111100
0000000011110000000111111111100000000000000000000000000111110000000011111111111110000000000111111100
0000000011111000000111111111110000000000000000000000000111111000000011111111111110000000000011111100
0000000001111100000011111111111000000000000000000000000111111000000011111111111110000000000001111110
0000000001111100000000111111111100000000000000000000000111111100000111111111111100000000000001111110
0000000011111110000000000000111110001100000000000000000111111110001111111111111100000000000000111110
0000000011111111111100000000011111111110000000000000000011111111111111111111111110000000000000011110
0000000011111111111111100000001111111110000000000000000000111111111111111111111111000000000000001100
0000000011111111111111110000000111111110000000000000000000011111111111111111111111100000000000000000
0000000111111111111111111000000111111111000000000000000000001111111111111111111111100000000000000000
0000011111111111111111111100000111111111100000000000000000000111111111111111111111110000000000000000
0000111111111111111111111100000111111111110000000000000000000111111111110001111111111000000000000000
0000111111111111111111111110000011111111110000000000000000000011111111100000000011111000000000000000
0000111111111111111111111111000011111111111000001110000000000000111111100000000001111100001110000000
0001111111111111111111111111100011110011111111111111000011000000011111100000000001111100011111000000
0001111111111111111111111111110011100001111111111111100111100000011111110000000001111100011111000000
0001111111111111111111111111110011100001111111111111111111110000111111110000000001111000011110000000
0000111111111111111111111111110011110011111111111111111111110000111111111000000000110000001110000000
0000111111111111111111111111100001111111111111111111111111100000111111111100000000000000001111000000
0000111111111111111111111111000000111111111110011111111111000000111111111110000000000000011111100000
0001111111111111111111111111000000111111111100001111111111000000111111111111110000000000111111111000
0001111111111111111111111111000000111111111100000110001111100000111111111111111000000001111111111100
0001111111111111111111111111100000111111111100000000000011110000111111111111111000000011111111111100
0001111111111111111111111111110000111111111110000000000001111001111111111000111100000011111111111100
0001111100011111111111111111111001111111111111000000000001111111111110000000011100000011111111111100
0001111000001111111111111111111111111111111111100001100001111111111100000000001110000011111111111000
0001111000000111111111111111111111111111111111111111110011111111111100000000000111000111111111000000
0001111100000011111111111111111111111111111111111111111111111111111100000000000011100111111110000000
0000111110000011111111111111111111111111111111111111111111111111111100000000000001100011111110000000
0000111111000111111111111111111111111111111111111111111111111111111110011100000001100001111110000000
0000011111111111111111111111111111111111111111111111111111111111111111111110000001100001111111000000
0000011111111111111111111111111111111111111111111111111111111111111111111111000011100001111111111000
0000011111111111111111111111111111111111111111111111111111111111111111111111100111100000111111111100
0000001111111111111111111111111111111111111111111111001111111111111111111111111111110000001111111100
0000000111111111111111111111111111111111111111111110000111111111111111111111111111110000000111111100
0000000111111111111111111111111111111111111111111110000011111111111111111111111111111000000111111100
0000001111111111111111111111111111111111111111111111000011111111111111111111111111111100000011111100
0000001111111111111111111111111111111111111111111111000011111111111111111111111111111100000011111100
0000011111111111111111111111111111111111111111111111100111111111111111111111111111111000000111111100
0000011111111111111111111111111111111111111111111111111111111111111111111111111111111000001111111100
0000011111111111111111111111111111111111111111111111111111111111111111111111111111111100011111111100
0000111111111111111111111111111111111111111111111111111111111111111111111111111111111110011111111100
0000111111111111111111111111111111111111111111111111111111111111111111111111111111111111111111111100
0000111111111111111111111111111111111111111111111111111111111111111111111111111111111111111111111100
0000111111111111111111111111111111111111111111111111111111111111111111111111111111111111111111111100
0000011111111111111111111111111111111111111111111111111111111111111111000001111111111111111111111100
0000011111111111111111111111111111111111111111111111111111111111111110000000111111111111111111111100
0000001111111111111111111111111111111111111111111111111111111111111110000000111111111111111111111110
0000000001111111111111111111111111111111111111111111111111111111111111000000111111111111111111111110
0000000000111111111111001111111111111111111111111111111111111111111111100000011111111111111111111110
0000110000111111111110000011111111111111111111111111111111111111111111110000011111111111111111111110
0001111001111111111110000001111111111111111111111111111111111111111111110000011111111111111111111100
0001111111111111111111000001111111111111111111111111111111111111111111110000011111111111111111111100
0000111111111111111111100011111111111111111111111111111111111111111111111000111111111111111111111100
0000011111111111111111100011111111111111111111111111111111111111111111111111111111111111111111111100
0000011111111111111111000001111111111111111111111111111111111111111111111111111111111111111111111110
0000001111111111111110000000111111110011111111111111111111111111111111111111111111111111111111111110
0000000001111111111110000000111111100001111111111111111111111111111111111111111111111111111111111110
0000000000111111111111000000111111100001111111111111000111111111111111111111001111111111111111111110
0000000000111111111111100000111111110011110001111110000011111111111111111110000011111111111111111100
0000000000011111111111110000111111111111100000111110000011111111111111111100000001111111111111111100
0000000000011111111111111001111111111111000000111110000001111111111111111000000000111111111111111100
0000000000011111111111111111111111111111000000111110000000110001111111111000000000011111111111111000
0000000000111111111111111111111111111110000000111110000000000000111111111100000000001111111111111000
0000000001111111111111111111111111000000000000011110000000000000011111111100000000001111111111111100
0000000001111111111111111111111110000000000000011110000000000000001111111100001100011111111111111100
0000000001111111111111111111111110000000000000011110000000000000001111111000011111111111111111111100
0000000001111111111111111111111110000000000000111110000000000000011111111100111111111111111111111100
0000000001111111111111111111111111001111000111111110000011111111111111111111111111111001111111111100
0000000000111111111111111111111111111111111111111110000111111111111111111111111111110000111111111100
0000000000001111111111111111111111111111111111111111000111111111111111111111111111110000111111111100
0000000000000111111111111111111111111111111111111111000011111111111111111111111111110000111111111110
0000000000000011111111111111111111111111111111111110000011111111111111111111111111110000011111111110
0000000000000011111111111111111111110011111111111100000011111111111111111111111111110000011111111110
0000011000000011111111111111111111100001111111111000000001111111111111111111111111110000001111111110
0000111100000011111111111111111111100001111111111000000000111111111111111111111111111000001111111110
0000111111000011111111111111111111110000111111111100000000111111111111111111111111111100000111111100
0000111111100111111111111111111111111000111111111110000000111111111111111111111111111100000111111100
0001111111111111111111111111111111111100011111111110000001111111111111111111111111111100001111111110
0011111111111111111111111111111111111110011111111111000011111111111111111111110001111000111111111110
0011111111111111111111111111111111111110001111111111100111111111111111111111100000110001111111111100
0011111111111111111111111111111111111110000111111111111111111111111111111111100000000001111111111100
0111111111111111111111111111111111111111000111111111111111111111111111111111100000000011111111111100
0111111111111111111111111111111111111111100011111111111111111111111111111111110000000011111111111110
0111111111111111111111111111111111111111100000111111111111111111111111111111111000000001111111111110
0111111111111111111111111111111111111111100000011111111111111111111111111111111100000001111111111100
0111111111111111111111111111111111111111110000011111111111111100111111111111111100000011111111111000
0111111111111111111111111111111111111111111100111111111111111000011111111111111110000011111111111000
0011111111111111111111111111111111111111111111111111111111110000001111111111111110000011111111111000
0001111111111111111111111111111111111111111111111111111111110000000111111111111111000011111111111100
0000111111111111111111111111111111111111111111111111111111111000000011111111111111000011111111111110
0000111111111111111111111111111111111111111111111111111111111000000000011111111110000111111111111110
0000111111111111111100111111111111111001111111111111111111111000000000001111111110000111111111111100
0000011111111111111000011111111111110000111111111111111111111000000000000111111110000011111111110000
0000000111000001110000001100000001100000011000001111000000110000000000000001111100000001111111100000
0000000000000000000000000000000000000000000000000000000000000000000000000000000000000000000000000000
