0000000000000000000000000000000000000000000000000000000000000000000000000000000000000000000000000000
0000000000000000000000000000000000000000000000000110000000000000000000000000000000000000000000000000
0000000000000000001100000000000000000000000000001111000000000000000000000000000000000000000000000000
0000011000000000011111100000000000000000000000001111100000000000000000000000000000000000000000000000
0000111100000000011111110000000000000000000000001111110000000000011000000000000000000000000000000000
0000111100000000001111110000000000000000000000011111110000000111111100000000000000000000001100000000
0000011110000000000111110000000000000000000000111111111000001111111100000000000000000000011110000000
0000001111100000000111110000000000000000000000111111111100001111111110000000000000000000011111000000
0000000111110000001111110000000000000000000000011111111111000111111110000011000000000000011111000000
0000000011111111111111111000000001100000000000001111111111100001111100000111100000000000011111000000
0000000011111111111111111000000011110000000000000111111111100000111100000111110011100000001110000000
0000000111111111111111111100000011111000000000000111111111100000011000001111111111110000001110000000
0000111111111111111111111110000001111111100000000011111111100000000000011111111111111000001100000000
0001111111111111111111111111100000111111110000000001111111000000000000011111111111111100001100000000
0001111111111111111111111111110000011111110000000001111111000000000000001111111111111100001100000000
0000111111111111111111111111110000001111111000000011111111100000000000000000011111111100001110000000
0000011111111111111111111111110000001111111100000111111111111111100000000000001111111100001111000000
0000011111111111111111111111111000001111111110001111111111111111110000000000000111111100001111100000
0000011111111111111111111111111100011111111111111111111111111111110000000000000111111110011111110000
0000001111111111111111111111111111111111111111111111111111111111110000000000000111111111111111111100
0000000001111111111111111111111111111111111111111111111111111111110000000000000111111111111111111110
0000000000111111111111111111111111111111111111111111111111111111110000000000000111111111111111111110
0000000000111111111100011111111111111111111111111111111111111111111001100000000111111111111111111100
0000000000111111110000001111111111111111111111111111111111111111111111110000001111111111111111111100
0000000000011111100000000111111111111111111111111111111111111111111111111000001111111111111111111100
0000000000011111100000000111111111111111111000111001111111111111111111111000011111111111111111111100
0000000000011111110000000111111111111111110000000000111111111111111111111100111111111111111111111100
0000000000001111111111001111111111111111100000000000011111111111111111111111111111111111111111111100
0000000000000111111111111111111111111111100000000000001111111111111111111111111111111111111111111100
0000000000000011111111111111111111111111000000000000000111111111111111111111111111111111111111111100
0000000000000001111111111111111111000000000000000000000111111111111111111111111111111111111111111000
0000000000000001111111111111111110000000000000000000000111111111111111111111111111111111111111000000
0000000000000001111111111111111110000000000000000000001111111111111111111111111111111111111110000000
0000000000000001111111111111111111000000000000000000001111111111111111111111111111111111111100000000
0000000000000000111111111111111111110000000000000000000111111111111111111111111111111111111100000000
0000000000000000011111111111111111111000011000011000000000111111111111111111111111111111111100000000
0000110000000000011111111111111111111000111100111110000000011111111111111111111111111100111100000000
0001111100000000011111111111111111111000111100111111000000001111111111111111111111111000011100000000
0001111110000000011111111111111111110000111100111111110000000111111111111111111111111000001110000000
0001111111000000011111111111111111110000111000111111111000000111111111111111111111111100001111000000
0001111111100000001111111111111111111001110000011111111000001111111111111111111111111110001111000000
0001111111110000000111111111111111111111110000011111111000111111111111111111111111111111000110000000
0011111111111110000111111111111111111111110000011111110001111111111111111111111111111111000000000000
0111111111111111001111111111111111111111110000001100000001111111111111111111111111111111000000000000
0111111111111111111111111111111111111111111000000000000000111111111111111111111111111111000000000000
0111111111111111111111111111111111111111111000000000000000011111111111111111111111111111000000000000
0111111111111111111111111111111111111111111000000000000000001111110000011111100011111111100000000000
0111111111111111111111111111111111111111111000001100000000001111100000001111000001111111110000000000
0111111111111111111111111111111111111111111100011110000000011111100000000110000001111111110000000000
0111111111111111111111111111111111111111111111111111110001111111000000000000000000111111111000000000
0011111111111111001111111111111111111111111111111111111111111111000000000000000000011111111000000000
0011111111111110000111111111111111111111111111111111111111111111000000000000000000011111111000000000
0011111111111100000111111111111111111111111111111111111111111111000011110000000000011111111100000000
0011111111111000000111111111111111111000011111111111111111111110000111111000000000011111111100000000
0111111111111000000111111111111111110000001111111111111111111110000111111100000000001111111110000000
0111111111110000000111111111111111110000000111111111111111111110000111111110000000001111111111000000
0011111111100000000011111111111111111000000111111111111111111100000111111111000000011111111111100000
0011111111100000000011111111111111111110001111111111111111111000000011111111100000011111111111110000
0011111111110000000011111111111111111111111111111111111111110000000001111111110000011111111111110000
0001111111111100000011111111111111111111111111111111111111110000000000111111110000011111111111111000
0001111111111110000111111111111111111111111111111111111111100000000000011111110000011111111111111100
0000111111111111111111111111111111111111111111111111111111000000000000011111110000011111111111111100
0000011111111111111111111111111111111111111111111111111111000001111100111111110000011111111111111100
0000011111111111111111111111111111111111111111111111111111000011111111111111100000001111111111111100
0000011111111111111111111111111111111111111111111111111111100111111111111111100000000011111111111100
0000001111111111111111111111111111111111111111111111111111111111111111111111000000000000111111111100
0000000110011111111111111111111111111111111111111111111001111111111111111111000000000000011111111110
0000000000001111111111111111111111111111111111111111110000111111111111111111000000000000011111111110
0000000000000111111111111111111111111111111111111111100000011111111111111111000000000000011111111100
0000000000000111111111111111111111111111111111111111100000001111111111111111000000000000111111111100
0000000000001111111111111111111111111111111111111111100000001111111111111111100000000000111111111110
0000000000011111111111111111111111111111111111110001110000000111111111111111100000000001111111111110
0000011000111111111111111111111111111111111111100000111000000011111111111111110000000001111111111100
0000111111111111111111111111111111111111111111100000011100000001111111111111110000000001111111111100
0001111111111111111111111111111111100011111111100000001110000001111000000111100000000001111111111100
0001111111111111111111111111111111000001111111100000001111000000110000000000000000000011111111111100
0001111111111111111111111111111111000001111111100000001111110000000000000000000000000011111111111100
0001111111111111111111111111111111000001111111100000011111111000000000000000000000000011111111111100
0000111111111111111111111111111111000001111111100000011111111000000000000000000000000001111111111100
0000111111111111111111111111111111100011111111110000011111110000000000000000000000000001111111111100
0000011001111111111111111111111111111111111111111100111111110000000000000000000000000001111111111100
0000000000111111111111111111111111111111111111111111111111110000000000000000000000000011111111111100
0000000000011111111111111111111111111100111111111111111111111001111111000000000000000111111111111000
0000000000000111111111111111111111110000011111111111111111111111111111100000000000001111111111110000
0000000000000011111111111111111111100000011111111111111111111111111111110000000000001111111111100000
0000000000000011111111110011111111100000001111111111111111111110011111111111100000001111100110000000
0000000000000111111111100001111111110000000111111111111111111100001111111111110000001111000000000000
0000000000001111111111100001111111111000000011111111000111111100000111111111111000001111000000000000
0000000000011111111111000011111111111100000011111110000011111110000011111111111100001111100000000000
0000000000111111111111000011111111111110000011111110000011111111000000111111111100001111100000000000
0000000000111111111111000011111111111110000011111110000001111111000000011111111110011111100000000000
0000000000111111111111000011111111111100000001111111000001111111000000011111111111111111000000000000
0000000000011111111111100011111111111000000001111111100001111111000000111111111111111110000000111000
0000000000001111111111110001111111111000000001111111100001111111000000111111111111111100000001111100
0000011000000111111111111000111111111100000001111111100000111111100000111111111111111000000001111100
0000111100000111111111111000011111111100000001111111000000111111110000111111111111110000000011111100
0000111110000011000111111000001111111000000000111110000000111111110000011111111111110000000011111000
0000111110000000000011110000000111110000000000011110000000011111110000001111111111100000000011111000
0000011100000000000000000000000000000000000000001100000000001111100000000000000111000000000001110000
0000000000000000000000000000000000000000000000000000000000000000000000000000000000000000000000000000
