0202020201030201
0202030203030101
0101010201030102
0303010101030101
0201020303030202
0101020101030201
0202020103010301
0202010101020102
