02020303
02020201
02020302
02020202
02010203
