00000000000000000000000000000000000000000000000000000000000000000000000000000000000000000000000000000000000000000000000000000000000000000000000000000
00000000000000000000000000000000000000000000000000000000000000000000000000000000000000000000000000000000000000000000000000000000000000000000000000000
00000000000000000000000000000000000000000000000000000000000000000000000000000000000000000000000000000000000000000000000000000000000000000000000000000
00000000000000000000000000000000000000000000000000000000000000000000000000000000000000000000000000000000000000000000000000000000000000000000000000000
00000000000000000000000000000000000000000000000000000000000000000000000000000000000000000000000000000000000000000000000000000000000000000000000000000
00000000000000000000000000000000000000000000000000000000000000000000000000000000000000000000000000000000000000000000000000000000000000000000000000000
00000000000000000000000000000000000000000000000000000000000000000000000000000000000000000000000000000000000000000000000000000000000000000000000000000
00000000000000000000000000000000000000000000000000000000000000000000000000000000000000000000000000000000000000000000000000000000000000000000000000000
00000000000000000000044444444444444444444444444444444444444444444444444444444444444444444444444444444444444000000000000000000000000000000000000000000
00000000000000000044444322211232123323123232113333322211322133231312113122322121111133313322231223131332111400000000000000000000000000000000000000000
00000000000000000444322113321122121111332223113223222312111113121111232232132211231111332212132131212232133440000000000000000000000000000000000000000
00000000000000000422121311233321321322123311333233133112223313233311211312223113213312332122132111333121221344000000000000000000000000000000000000000
00000000000000000423232321131313231211232113223123113223111332323313311133113311122121333233112333321123323324440000000000000000000000000000000000000
00000000000000000431233321232323323233331213232312323121323221221121231312323332212112211323311231123112122114444000000000000000000000000000000000000
00000000000000000044123231121321311313311332223122132221332213111111312231123222231311313121123121122221211221444400000000000000000000000000000000000
00000000000000000044231131221313321232322113321311122322311121233331121233312221212323232213212112221113211312344440000000000000000000000000000000000
00000000000000000000422133122132111231231213131122331112233123312231131123331322322211232331322322212222113312322240000000000000000000000000000000000
00000000000000000000033332332133113131233111133322112123233211312211222232331321323231233111211122311322121313111244000000000000000000000000000000000
00000000000000000000002122111222312123231321112313331133113113131333311321232322221333113132311333112123133323233444400000000000000000000000000000000
00000000000000000000000423333111213231213333211132111232111331231122133121112112123312231212211123112121322313321244440000000000000000000000000000000
00000000000000000000000041132323223123221221321133333213132321332123212211333222221333223122312132213311113322323344444000000000000000000000000000000
00000000000000000000000004231121333111132133112131132312311112213332112311222111121312321333131112213133131313233234444000000000000000000000000000000
00000000000000000000000000442112233333133312223122232233213221111331132122232212113121312313332332221313322221213122444400000000000000000000000000000
00000000000000000000000000041213332112131322113333231213111122132322223213312132111212222333211123331233233112213221444400000000000000000000000000000
00000000000000000000000000044111211233233132223313323211312313212122331213111133312313332322112333112223333213313331333400000000000000000000000000000
00000000000000000000000000004411312323122113232112332311123333313121121231113323333233112213113323231232111223123312331434400000000000000000000000000
00000000000000000000000000000444133211222332112133122132213231322333112322213213322312231322332222212131133113322333113444400000000000000000000000000
00000000000000000000000000000004422113123131222232332221113321312233322133123112331232313121333223113132132132121333131214400000000000000000000000000
00000000000000000000000000000004432333322211221112112312311131313231312112233122232313331233121321111223313212333211321344400000000000000000000000000
00000000000000000000000000000000441222231321213212111311313122213322113233212112311321323232223113122123232112113211331344440000000000000000000000000
00000000000000000000000000000000044223322312123312132333211323223132131311121213113133133223323331212222321223113122313344440000000000000000000000000
00000000000000000000000000000000004421223212123312131332111222233221322121222231131222223211313223333121333322313321331234444000000000000000000000000
00000000000000000000000000000000004211231331121213233112111111311133233131331112321322321122213332321131333331313312122424440400000000000000000000000
00000000000000000000000000000000000044321221323233122333223212123213211231231131133211221333121322121331222131122221231344444400000000000000000000000
00000000000000000000000000000000000044411221232321321213131331113211111321312112133133213133112222321132311333211113311144440400000000000000000000000
00000000000000000000000000000000000000441113132212122231212232321322312121113123321231123322322123211211221323332122332312444000000000000000000000000
00000000000000000000000000000000000000044221222331231122112231312323113131222211313231122321112311133122211121322113322144444400000000000000000000000
00000000000000000000000000000000000000004431113321231113131113313111211333122113231231332321331212222221232313222313222244444400000000000000000000000
00000000000000000000000000000000000000004441323112221132133232121313232112211213113113232332323311132231213131221213322324444400000000000000000000000
00000000000000000000000000000000000000000444312221213213121123233111133223122313113331313131132131321222133331131211132224444400000000000000000000000
00000000000000000000000000000000000000000044411322323322333122222121333223312231311312122312331321113223223121211131323244444000000000000000000000000
00000000000000000000000000000000000000000000444323231222122211112321112331213322312321212232311222312331322333312313111442200000000000000000000000000
00000000000000000000000000000000000000000000044441133331131133111311321132112232131313211213323123132132111331222122344411000000000000000000000000000
00000000000000000000000000000000000000000000004442131331311323131132212132331132223321123131231323332333313221122334444303000000000000000000000000000
00000000000000000000000000000000000000000000000444144323321223221313223311323231221132213211122212321113331112332144440000000000000000000000000000000
00000000000000000000000000000000000000000000000000444423321122323112132112331113322112213321311132312113231311144434000000000000000000000000000000000
00000000000000000000000000000000000000000000000000044444441443312332211311333311211313133122322332124444444444444400000000000000000000000000000000000
00000000000000000000000000000000000000000000000000000000444444444444444444444444444444444444444444440000000000000000000000000000000000000000000000000
00000000000000000000000000000000000000000000000000000000000000444444444444444444444444444444444000000000000000000000000000000000000000000000000000000
00000000000000000000000000000000000000000000000000000000000000000000000000000000000000000000000000000000000000000000000000000000000000000000000000000
00000000000000000000000000000000000000000000000000000000000000000000000000000000000000000000000000000000000000000000000000000000000000000000000000000
00000000000000000000000000000000000000000000000000000000000000000000000000000000000000000000000000000000000000000000000000000000000000000000000000000
00000000000000000000000000000000000000000000000000000000000000000000000000000000000000000000000000000000000000000000000000000000000000000000000000000
00000000000000000000000000000000000000000000000000000000000000000000000000000000000000000000000000000000000000000000000000000000000000000000000000000
