00000000000000000000000000000000000000000000000000000000000000000000000000000000000000000000000000000000000000000000000000000000000000000000000000000
00000000000000000000000000000000000000000000000000000000000000000000000000000000000000000000000000000000000000000000000000000000000000000000000000000
00000000000000000000000000000000000000000000000000000000000000000000000000000000000000000000000000000000000000000000000000000000000000000000000000000
00000000000000000000000000000000000000000000000000000000000000000000000000000000000000000000000000000000000000000000000000000000000000000000000000000
00000000000000000000000000000000000000000000000000000000000000000000000000000000000000000000000000000000000000000000000000000000000000000000000000000
00000000000000000000000000000000000000000000000000000000000000000000000000000000000000000000000000000000000000000000000000000000000000000000000000000
00000000000000000000000000000000000000000000000000000000000000000000000000000000000000000000000000000000000000000000000000000000000000000000000000000
00000000000000000000000000000000000000000000000000000000000000000000000000000000000000000000000000000000000000000000000000000000000000000000000000000
00000000000000000000044444444444444444444444444444444444444444444444444444444444444444444444444444444444444000000000000000000000000000000000000000000
00000000000000000044444121213332132111233321113313122333311123231313113122311333211221222112313223113123221400000000000000000000000000000000000000000
00000000000000000444333311213113131332111221323323333321122112321123332321221311131322322221211221211332333440000000000000000000000000000000000000000
00000000000000000422322223232233312232231313223213313133233222123222111321131233311113131311322323333321323344000000000000000000000000000000000000000
00000000000000000423121213312112122132131123231321332332131112331322321332223121332133112321131221212333213234440000000000000000000000000000000000000
00000000000000000433313111312211322112323112121311132233211333331233123223133211322213113332321221212212211234444000000000000000000000000000000000000
00000000000000000044233121232231213322332311322232133323111322323312213221331122232133211221222223333112323212444400000000000000000000000000000000000
00000000000000000044131233321222312331233232112133223311313231322211313131122313133132213311122323322133233322244440000000000000000000000000000000000
00000000000000000000411233312331321213333231213133323122122312231223122311131113311221211323111132221211331223333340000000000000000000000000000000000
00000000000000000000021121112313223112133133311321123313121332122333322331312322233311121333132231131113322131232144000000000000000000000000000000000
00000000000000000000003321132331221111122232212323222313132113111113131321311133133321223111323132231223312221333444400000000000000000000000000000000
00000000000000000000000412232333332112313221213233112322122323213333133112311213213213311111213323312123333313222144440000000000000000000000000000000
00000000000000000000000041122322112112113323331113231311221111133121233321221222312133132122233312311132121232311344444000000000000000000000000000000
00000000000000000000000004131113312322233132232231111323322211112232221121232232212221211132113311221332313233333134444000000000000000000000000000000
00000000000000000000000000441121313132223313122321131113332222322121321331222321312211123233223222111121221323132232444400000000000000000000000000000
00000000000000000000000000042112113331232223332112222311221321132122311323121322121222111123133332313231332123233223444400000000000000000000000000000
00000000000000000000000000044132111313232122331321333121232112223111321133322112111112131312123332331122323222122312233400000000000000000000000000000
00000000000000000000000000004431131311113233111232211313222133113232113331322331222123131233113131121113313332111333322434400000000000000000000000000
00000000000000000000000000000444323222311232313122333111321321313223121112211112233311332223331323313333223331313212311444400000000000000000000000000
00000000000000000000000000000004431223321131133211311132332111321332323221113213231122223331223333331122113222132113212114400000000000000000000000000
00000000000000000000000000000004432113232211322311131223212311221313313222133333233111131213112331133332212212231213222144400000000000000000000000000
00000000000000000000000000000000443132233231233331213123312222123332113231231123121112123332213333223211233122112332233344440000000000000000000000000
00000000000000000000000000000000044223322121123321332111131212332223211211313321211111112113131133121212312323221123122344440000000000000000000000000
00000000000000000000000000000000004411333212222232321211333231223121222313222131313221112131223322313232231221333123222224444000000000000000000000000
00000000000000000000000000000000004131312212133333213333113333322232332332222111311232231233333131213111211221233132122414440400000000000000000000000
00000000000000000000000000000000000044322122131233123332322331331121333223223131233113122131112331221123312113311313321344444400000000000000000000000
00000000000000000000000000000000000044412322222211213322131323113131311333123221231111121233112231221231313212231112211344440400000000000000000000000
00000000000000000000000000000000000000441112322222333222123211222313232313313211113313322223322222122222122233322123211122444000000000000000000000000
00000000000000000000000000000000000000044233232123323221132213232313223311211313121222221112112331123221312111233323211344444400000000000000000000000
00000000000000000000000000000000000000004432312221322312122113231331111211222313211233112222111312131311113122322221231244444400000000000000000000000
00000000000000000000000000000000000000004442211323111332312323113123133332331132232133112312112231122123221121331312223224444400000000000000000000000
00000000000000000000000000000000000000000444233321213211233133321111133111221332113231113133231333312321321332231231131114444400000000000000000000000
00000000000000000000000000000000000000000044423233111313233331222331123323232223233333212233123321113112113231321313311144444000000000000000000000000
00000000000000000000000000000000000000000000444212313321333111111333311232231313122311221121223331123212332111212132211441300000000000000000000000000
00000000000000000000000000000000000000000000044442211211222313112133331223322312331223332113331313233232211222333233144411000000000000000000000000000
00000000000000000000000000000000000000000000004442222223122222211111232212211221122111311111233222111133133211313214444101000000000000000000000000000
00000000000000000000000000000000000000000000000444344113212121311313133332221111333131233231123221331322121313313144440000000000000000000000000000000
00000000000000000000000000000000000000000000000000444433113331111223232221231331112313322113333212332312212312144424000000000000000000000000000000000
00000000000000000000000000000000000000000000000000044444442442313322121111223312222312122112212321334444444444444400000000000000000000000000000000000
00000000000000000000000000000000000000000000000000000000444444444444444444444444444444444444444444440000000000000000000000000000000000000000000000000
00000000000000000000000000000000000000000000000000000000000000444444444444444444444444444444444000000000000000000000000000000000000000000000000000000
00000000000000000000000000000000000000000000000000000000000000000000000000000000000000000000000000000000000000000000000000000000000000000000000000000
00000000000000000000000000000000000000000000000000000000000000000000000000000000000000000000000000000000000000000000000000000000000000000000000000000
00000000000000000000000000000000000000000000000000000000000000000000000000000000000000000000000000000000000000000000000000000000000000000000000000000
00000000000000000000000000000000000000000000000000000000000000000000000000000000000000000000000000000000000000000000000000000000000000000000000000000
00000000000000000000000000000000000000000000000000000000000000000000000000000000000000000000000000000000000000000000000000000000000000000000000000000
