00000000000000000000000000000000000000000000000000000000000000000000000000000000000000000000000000000000000000000000000000000000000000000000000000000
00000000000000000000000000000000000000000000000000000000000000000000000000000000000000000000000000000000000000000000000000000000000000000000000000000
00000000000000000000000000000000000000000000000000000000000000000000000000000000000000000000000000000000000000000000000000000000000000000000000000000
00000000000000000000000000000000000000000000000000000000000000000000000000000000000000000000000000000000000000000000000000000000000000000000000000000
00000000000000000000000000000000000000000000000000000000000000000000000000000000000000000000000000000000000000000000000000000000000000000000000000000
00000000000000000000000000000000000000000000000000000000000000000000000000000000000000000000000000000000000000000000000000000000000000000000000000000
00000000000000000000000000000000000000000000000000000000000000000000000000000000000000000000000000000000000000000000000000000000000000000000000000000
00000000000000000000044444444444444444444444444444444444444444444444444444444444444444444444444444444440000000000000000000000000000000000000000000000
00000000000000044444444444444444444444444444444444444444444444444444444444444444444444444444444444444444444000000000000000000000000000000000000000000
00000000044444444444444121322122112123222322133122322223311122322232312123233333331332131112222321311132112400000000000000000000000000000000000000000
00000000442121313112231123222223122131323122331233223132321211222333311333321121211222123322123331113333332440000000000000000000000000000000000000000
00000000444111331111332321231223333211211223131213221132332223232333213311212232232331123332321213211121223144000000000000000000000000000000000000000
00000000044433231112131212231233323333233112111333332323311312231212122211222222313323133122311322122311231124440000000000000000000000000000000000000
00000000044223112231211221333332122133212333311132212333311211212332211321121222111121132121332333113312113124444000000000000000000000000000000000000
00000000004444311131131321233332311221313322223123122222312232113111222133133111313131133323313232233113123233444400000000000000000000000000000000000
00000000000004444233223112223311211331211113222212322121213111313223332333231222232113231331333122232123221233344440000000000000000000000000000000000
00000000000000044444413323332131333321331121213211211312211313212231232123213231222223311233331323223332111132232140000000000000000000000000000000000
00000000000000000044422112321332222132312321212121313233113111331333311211222232313122131132123323231233212321232344000000000000000000000000000000000
00000000000000000000442323212321212321122222211111232131313133232212231311132332133333213211112323222232232311321444400000000000000000000000000000000
00000000000000000000044412321131112212323313121331323113122121123111211312232311223322231133332133211123312321222344440000000000000000000000000000000
00000000000000000000004443332233112231113332312221113111112211331113132222222333132332123123122231212211232112122244444000000000000000000000000000000
00000000000000000000000044212112311211113313221323313311333321232322121113321312232113132312221213211311123321333134444000000000000000000000000000000
00000000000000000000000004443121112112133312311322332112222213122313132322221222233112222233131113112321323221332211444400000000000000000000000000000
00000000000000000000000000441332222321221131112233231131333131131233331132313323321132131311212132313212311211132331444440000000000000000000000000000
00000000000000000000000000444321322123211323321132232121113313233121122111311133333121232233333312113221121231331321223440000000000000000000000000000
00000000000000000000000000044433223121323133132333112121323331232221132332232222112233222111132121233222122121311233313444400000000000000000000000000
00000000000000000000000000004444111212333333123111233331221333321221313113112231312122113111332133113231121312121221231444400000000000000000000000000
00000000000000000000000000000044411223232123121323312112232133222112332232312333233212112322231323122332123112121111131214400000000000000000000000000
00000000000000000000000000000004411313212211332122221221311331223123133311212223311323323113233221213222212111113122323344400000000000000000000000000
00000000000000000000000000000000441313123322113322131131332322113111111112112231123212231321211232132112312233233231213344440000000000000000000000000
00000000000000000000000000000000044133131322223322331313322122321133333311121123112132321221212331231131331232312323132244440000000000000000000000000
00000000000000000000000000000000004413213222123111121222221211122132331332122332322122333131323113233233211113133331313224444000000000000000000000000
00000000000000000000000000000000004322133131123223211112112321231212321333222121331112323121332233332132122123331111233434444400000000000000000000000
00000000000000000000000000000000000044233133311213231312122112223332121231112211133213212323131312322121211122121323111244444400000000000000000000000
00000000000000000000000000000000000044432311313132311232323221312221313113233122121313133221312313223123132222221313332344444400000000000000000000000
00000000000000000000000000000000000000441122313332332213112312113133321211312232131213223311111312111123233232323123323232444440000000000000000000000
00000000000000000000000000000000000000044132213211331223323211221123322213333221121332233332231233123333123323112221231344444440000000000000000000000
00000000000000000000000000000000000000004433212222313222221313333133221313213233333311322311321321211312322332323121322344444440000000000000000000000
00000000000000000000000000000000000000004442123232332311123321223332233222323331332222121113321112323232331131312212213234444440000000000000000000000
00000000000000000000000000000000000000000444221223211113212111233321332231123311322132331121332133232232122331332313121234444440000000000000000000000
00000000000000000000000000000000000000000044431331323213322211323132311331123122321133213333312231211331121312111313211144444400000000000000000000000
00000000000000000000000000000000000000000000444332121133332313132132111333212232122322113212312321122211331312221313323444444000000000000000000000000
00000000000000000000000000000000000000000000044442122333123233122212132131332133131111332123123131113233112313313323144444440000000000000000000000000
00000000000000000000000000000000000000000000004443231112122221212222223213132331112331321212211323321133121313223134444444400000000000000000000000000
00000000000000000000000000000000000000000000000444144311121223313312333213133231322132221221131221211213331331311344444440000000000000000000000000000
00000000000000000000000000000000000000000000000000444412321122223122232212213331222133223113113222222212122313344444444000000000000000000000000000000
00000000000000000000000000000000000000000000000000044444441441311221111232221323233223222221223131214444444444444444400000000000000000000000000000000
00000000000000000000000000000000000000000000000000000000444444444444444444444444444444444444444444444440000000000000000000000000000000000000000000000
00000000000000000000000000000000000000000000000000000000000000444444444444444444444444444444444000000000000000000000000000000000000000000000000000000
00000000000000000000000000000000000000000000000000000000000000000000000000000000000000000000000000000000000000000000000000000000000000000000000000000
00000000000000000000000000000000000000000000000000000000000000000000000000000000000000000000000000000000000000000000000000000000000000000000000000000
00000000000000000000000000000000000000000000000000000000000000000000000000000000000000000000000000000000000000000000000000000000000000000000000000000
00000000000000000000000000000000000000000000000000000000000000000000000000000000000000000000000000000000000000000000000000000000000000000000000000000
00000000000000000000000000000000000000000000000000000000000000000000000000000000000000000000000000000000000000000000000000000000000000000000000000000
