00000000000000000000000000000000000000000000000000000000000000000000000000000000000000000000000000000000000000000000000000000000000000000000000000000
00000000000000000000000000000000000000000000000000000000000000000000000000000000000000000000000000000000000000000000000000000000000000000000000000000
00000000000000000000000000000000000000000000000000000000000000000000000000000000000000000000000000000000000000000000000000000000000000000000000000000
00000000000000000000000000000000000000000000000000000000000000000000000000000000000000000000000000000000000000000000000000000000000000000000000000000
00000000000000000000000000000000000000000000000000000000000000000000000000000000000000000000000000000000000000000000000000000000000000000000000000000
00000000000000000000000000000000000000000000000000000000000000000000000000000000000000000000000000000000000000000000000000000000000000000000000000000
00000000000000000000000000000000000000000000000000000000000000000000000000000000000000000000000000000000000000000000000000000000000000000000000000000
00000000000000000000000000000000000000000000000000000000000000000000000000000000000000000000000000000000000000000000000000000000000000000000000000000
00000000000000000000044444444444444444444444444444444444444444444444444444444444444444444444444444444444444000000000000000000000000000000000000000000
00000000000000000044444231321223131331232311322311133132333322331221133232133321332121321212232323321322311400000000000000000000000000000000000000000
00000000000000000444313312112312333122113123332313312332332133112323331131323132232113233121313131132212332440000000000000000000000000000000000000000
00000000000000000421211223331222313332322231223131311332222213222233311122133123211332311132232213232112312144000000000000000000000000000000000000000
00000000000000000411331223311222112121113122122231221221331232123321121322313111322121113321131221212111233124440000000000000000000000000000000000000
00000000000000000413213123232132213132311323331223223113122122311213232123221132122221331132222233121322123334444000000000000000000000000000000000000
00000000000000000044131333131333321123232322131123331132113112333133132312312121331233332211122131321212213333444400000000000000000000000000000000000
00000000000000000044322223331311133333123322132311122123131213211131332113112213211232121122222111311312121331144440000000000000000000000000000000000
00000000000000000000433223113231333322113332232113233122313331133113112323321321333312123221233223131133233133321140000000000000000000000000000000000
00000000000000000000011211232133111233332112321113221112333113123213221231323211112233312232323111112223311122323344000000000000000000000000000000000
00000000000000000000002213222111113211321311232321232311131222321331131313223331321223221123231233133131111323213444400000000000000000000000000000000
00000000000000000000000421231131322323233313321322131231133231113123112321133111322211331121321112131322231311223344440000000000000000000000000000000
00000000000000000000000043122232331312233231123321132213313133113132311321121311222333131111312222112321213312112344444000000000000000000000000000000
00000000000000000000000004322333222313131112131313332131232313112332111211112231223313212312223313233321322133121114444000000000000000000000000000000
00000000000000000000000000443311312232121331213123231211132112311332233123321321132132311132212222312231311312323213444400000000000000000000000000000
00000000000000000000000000042131121323232112222321112311222122122123323331131233233312211323122123223113222313312132444400000000000000000000000000000
00000000000000000000000000044213322212212131322322311111111231113331111222313321211213321221332112121131322111212133213400000000000000000000000000000
00000000000000000000000000004411112313111313113212322123131122232122211221321332133121323221132333123332232211331313321414400000000000000000000000000
00000000000000000000000000000444122232233121231131211121121133322121311213131322321222222121131133133211123323121233112444400000000000000000000000000
00000000000000000000000000000004423222312233133323331113111121221221213332211331231113222321112132111123213213213332221314400000000000000000000000000
00000000000000000000000000000004413222212213231221231223121112333133223112133122331231231132132233123313313333222333122244400000000000000000000000000
00000000000000000000000000000000442322111221221232221331233331332221313233333331132312323113312231221223331132231212322244440000000000000000000000000
00000000000000000000000000000000044311123123113223323232123233333121333322233113233122312232313322322112113121212323223144440000000000000000000000000
00000000000000000000000000000000004411131222232313311323333122312323222222233232111313221311223123131121321333311113231114444000000000000000000000000
00000000000000000000000000000000004121322212231222132232233113113313331133332313233222331323113331333323132333332132132424440400000000000000000000000
00000000000000000000000000000000000044312321221233311122133222332132331333111121212113213213132221321121332131311313323344444400000000000000000000000
00000000000000000000000000000000000044412332311221333112333313312333333223132131322123133122123132332221213222221333223344440400000000000000000000000
00000000000000000000000000000000000000441213121323323323132311333111321121221313123212233131313322133321112213222213133133444000000000000000000000000
00000000000000000000000000000000000000044332333112112312213232211312231123113211122132122332232333122311232331113212133344444400000000000000000000000
00000000000000000000000000000000000000004413322131213233132121311322221331122333312213121331231221311333221131221311231144444400000000000000000000000
00000000000000000000000000000000000000004442223223121332312123223123131323133211232222131211222321132332212321121331121324444400000000000000000000000
00000000000000000000000000000000000000000444231323213213321321231231322113112121332211223311333332311112122133221123212334444400000000000000000000000
00000000000000000000000000000000000000000044431123131311332222111113122213122211121233113133222232111131213232221123321344444000000000000000000000000
00000000000000000000000000000000000000000000444233231133233323111132132333122212113223221333221212213313232221213111322443100000000000000000000000000
00000000000000000000000000000000000000000000044442113222113322111313233323111132113312221231132223111122311123332233144413000000000000000000000000000
00000000000000000000000000000000000000000000004442213311131312112112212333121111232311222333232123222313221321111124444301000000000000000000000000000
00000000000000000000000000000000000000000000000444144331111322313133121312112113123311333132223211311332213122313244440000000000000000000000000000000
00000000000000000000000000000000000000000000000000444413322231131132231113322113123331323321123331221233121231144424000000000000000000000000000000000
00000000000000000000000000000000000000000000000000044444442442332233311332332223212231122123311313324444444444444400000000000000000000000000000000000
00000000000000000000000000000000000000000000000000000000444444444444444444444444444444444444444444440000000000000000000000000000000000000000000000000
00000000000000000000000000000000000000000000000000000000000000444444444444444444444444444444444000000000000000000000000000000000000000000000000000000
00000000000000000000000000000000000000000000000000000000000000000000000000000000000000000000000000000000000000000000000000000000000000000000000000000
00000000000000000000000000000000000000000000000000000000000000000000000000000000000000000000000000000000000000000000000000000000000000000000000000000
00000000000000000000000000000000000000000000000000000000000000000000000000000000000000000000000000000000000000000000000000000000000000000000000000000
00000000000000000000000000000000000000000000000000000000000000000000000000000000000000000000000000000000000000000000000000000000000000000000000000000
00000000000000000000000000000000000000000000000000000000000000000000000000000000000000000000000000000000000000000000000000000000000000000000000000000
