00000000000000000000000000000000000000000000000000000000000000000000000000000000000000000000000000000000000000000000000000000000000000000000000000000
00000000000000000000000000000000000000000000000000000000000000000000000000000000000000000000000000000000000000000000000000000000000000000000000000000
00000000000000000000000000000000000000000000000000000000000000000000000000000000000000000000000000000000000000000000000000000000000000000000000000000
00000000000000000000000000000000000000000000000000000000000000000000000000000000000000000000000000000000000000000000000000000000000000000000000000000
00000000000000000000000000000000000000000000000000000000000000000000000000000000000000000000000000000000000000000000000000000000000000000000000000000
00000000000000000000000000000000000000000000000000000000000000000000000000000000000000000000000000000000000000000000000000000000000000000000000000000
00000000000000000000000000000000000000000000000000000000000000000000000000000000000000000000000000000000000000000000000000000000000000000000000000000
00000000000000000000000000000000000000000000000000000000000000000000000000000000000000000000000000000000000000000000000000000000000000000000000000000
00000000000000000000044444444444444444444444444444444444444444444444444444444444444444444444444444444444444000000000000000000000000000000000000000000
00000000000000000044444121222212222133311211313232333222112121123212133233111311323213312232132232221111322400000000000000000000000000000000000000000
00000000000000000444223133111222231321132232111221231113121232331323113331121211213112133232132222222212232440000000000000000000000000000000000000000
00000000000000000412231123123213112132333121322322231112123123311321333112212113212112112211313331333332112344000000000000000000000000000000000000000
00000000000000000422233211132323232232112112222232131131221222131231111321223313321133131112133131212112313334440000000000000000000000000000000000000
00000000000000000411313113111221333231121231321331313113323131231322232233332112212231212321331223133133122214444000000000000000000000000000000000000
00000000000000000044311232332333121113313223232131322222231133133321322122131231131212221322123231132322131133444400000000000000000000000000000000000
00000000000000000044311221222113231211231121323212313231311321221221212113112112212333323222221322333232112131244440000000000000000000000000000000000
00000000000000000000423111332221223131133133133123212312212123133312132232313213222213121122212313212222213323323240000000000000000000000000000000000
00000000000000000000011112122122321213111231311123222233133231321221113131322211132212332212312123233131211213132344000000000000000000000000000000000
00000000000000000000003122321232322232123233312113123222121332221331212333311122123123333232133321321132333323212444400000000000000000000000000000000
00000000000000000000000421222112332332312232333121233233323323332211132321233111122321332123323211132331232313312244440000000000000000000000000000000
00000000000000000000000043323223333323121312211233121132332231111232322233212123131211231112232322332131121132323244444000000000000000000000000000000
00000000000000000000000004222221222122232333331223331311111211222133233123323112132311332133213232322323231122333224444000000000000000000000000000000
00000000000000000000000000442223331211113311222222223313121132211223333222233221313221121213313213211332232333312322444400000000000000000000000000000
00000000000000000000000000041121312211132223223123131223231121333123333232321121112233113231222222333323233312211121444400000000000000000000000000000
00000000000000000000000000044132211133323333333223211223113221232322232332111211322133221132211113221232131312331222322400000000000000000000000000000
00000000000000000000000000004422133211111331232223333331313313321111233213123211122313121312113331222332212123321322321434400000000000000000000000000
00000000000000000000000000000444211312231331231133311323122323121232313212312331233131112113331312312233133331333211233444400000000000000000000000000
00000000000000000000000000000004411331233123132213111313212222221213332211311221312112223121222111123323232233221212123314400000000000000000000000000
00000000000000000000000000000004413222322323121213313313231223111222222212131211213223121133133223213313132313112213232144400000000000000000000000000
00000000000000000000000000000000442132313233331213133322123211232223223323232311111322332233212232123212132211132221321244440000000000000000000000000
00000000000000000000000000000000044223132232113313131122233231133121232321312212213113233121133223213212232111312122311144440000000000000000000000000
00000000000000000000000000000000004431311223311221313212122111133213131112223223112212312121122322123322111313312121211114444000000000000000000000000
00000000000000000000000000000000004322333122333111111331111312232123122231213212323221123223222111332213131113313233331414440400000000000000000000000
00000000000000000000000000000000000044332323333331212322311133311312332212313133132131122233213312322123323113311333123344444400000000000000000000000
00000000000000000000000000000000000044411122121111122231321132122113322111133213323331232222333212313231233323232233121344440400000000000000000000000
00000000000000000000000000000000000000442311323223121212313131122311322112233212112212311223212332122221121311113321231232444000000000000000000000000
00000000000000000000000000000000000000044332211113212322111322232123322231322131123313311123221313222112233313213322212144444400000000000000000000000
00000000000000000000000000000000000000004413123133312223122223213333132113113312333121222132312311223223212322332213221144444400000000000000000000000
00000000000000000000000000000000000000004442113321123321331332311122113212331313312231222112223133221212313112322312211124444400000000000000000000000
00000000000000000000000000000000000000000444113232122132323121231211323333323313233213213231131332222331213312312111231134444400000000000000000000000
00000000000000000000000000000000000000000044421333311133332122222321331333121213321323123133133122221211222222231213132244444000000000000000000000000
00000000000000000000000000000000000000000000444213111131123133322311211111323112111113111231113132221132323211311231223442300000000000000000000000000
00000000000000000000000000000000000000000000044441133222133333233322131221121132323221223211212211233213322223221211244421000000000000000000000000000
00000000000000000000000000000000000000000000004441323332122321312221232113131111233133131131121131311332133321323114444301000000000000000000000000000
00000000000000000000000000000000000000000000000444344133321321331212113221123222233113312323223232312112113322213144440000000000000000000000000000000
00000000000000000000000000000000000000000000000000444422333131322112211113123123121232212121221223223213312231144414000000000000000000000000000000000
00000000000000000000000000000000000000000000000000044444442441333131123311231333112321221233122212114444444444444400000000000000000000000000000000000
00000000000000000000000000000000000000000000000000000000444444444444444444444444444444444444444444440000000000000000000000000000000000000000000000000
00000000000000000000000000000000000000000000000000000000000000444444444444444444444444444444444000000000000000000000000000000000000000000000000000000
00000000000000000000000000000000000000000000000000000000000000000000000000000000000000000000000000000000000000000000000000000000000000000000000000000
00000000000000000000000000000000000000000000000000000000000000000000000000000000000000000000000000000000000000000000000000000000000000000000000000000
00000000000000000000000000000000000000000000000000000000000000000000000000000000000000000000000000000000000000000000000000000000000000000000000000000
00000000000000000000000000000000000000000000000000000000000000000000000000000000000000000000000000000000000000000000000000000000000000000000000000000
00000000000000000000000000000000000000000000000000000000000000000000000000000000000000000000000000000000000000000000000000000000000000000000000000000
