0302010203030302
0101030103020202
0301030103020102
0302030201030102
0202010201030102
0302010303030201
0201010301030103
0301030101010102
