01030101
03010201
01030303
02020303
02020102
