0301030203020103
0302010201030102
0302010302010203
0103020103010203
0103030101010202
0302030101010102
0302030202030102
0201010203020103
