00000000000000000000000000000000000000000000000000000000000000000000000000000000000000000000000000000000000000000000000000000000000000000000000000000
00000000000000000000000000000000000000000000000000000000000000000000000000000000000000000000000000000000000000000000000000000000000000000000000000000
00000000000000000000000000000000000000000000000000000000000000000000000000000000000000000000000000000000000000000000000000000000000000000000000000000
00000000000000000000000000000000000000000000000000000000000000000000000000000000000000000000000000000000000000000000000000000000000000000000000000000
00000000000000000000000000000000000000000000000000000000000000000000000000000000000000000000000000000000000000000000000000000000000000000000000000000
00000000000000000000000000000000000000000000000000000000000000000000000000000000000000000000000000000000000000000000000000000000000000000000000000000
00000000000000000000000000000000000000000000000000000000000000000000000000000000000000000000000000000000000000000000000000000000000000000000000000000
00000000000000000000000000000000000000000000000000000000000000000000000000000000000000000000000000000000000000000000000000000000000000000000000000000
00000000000000000000044444444444444444444444444444444444444444444444444444444444444444444444444444444444444000000000000000000000000000000000000000000
00000000000000000044444332321133211213321313322311233131333132223211211213211223311133331111123331231323122400000000000000000000000000000000000000000
00000000000000000444321223133333322211321233213313333121231321132233221122312332332232121313222122123311223440000000000000000000000000000000000000000
00000000000000000413321333231212331222133131132322332113133122333121323332322121122231121211132121331133233344000000000000000000000000000000000000000
00000000000000000413233113122231313322133232211311122211123313332332312231322212332313223113321321332112121324440000000000000000000000000000000000000
00000000000000000411321333121213333311222131333321321333332333313123313221311313131231132313132322312222133114444000000000000000000000000000000000000
00000000000000000044122313323322131211322231112331233213121221331322311112213213121111222233131313323211131322444400000000000000000000000000000000000
00000000000000000044231332311223311232321122321221111313322122312331132111322213331223221233221132312113222112144440000000000000000000000000000000000
00000000000000000000421311122332321322211123333113131312223231133132212222113333212313222233313211312313123333123340000000000000000000000000000000000
00000000000000000000021313312223323323133331132221111321132322233231232133221212211131211212232222121132311332322244000000000000000000000000000000000
00000000000000000000002123322322112322311121233231133132112331123231122131121122323312322331132222122132233121231444400000000000000000000000000000000
00000000000000000000000422333331321113222312321113121111222113233211231222332313312112323111132333132332213232112144440000000000000000000000000000000
00000000000000000000000042122131333112131312111111232332122123112311113322211112233313231223321322122112121331121244444000000000000000000000000000000
00000000000000000000000004131111223223232311222112121312332121331113232121111231233131223112133212321112211331321314444000000000000000000000000000000
00000000000000000000000000442333133132123211231123333133233222313131111332331223133323321332313332333133323133321331444400000000000000000000000000000
00000000000000000000000000041221233122131121121121113223221122312232121323322213331231321232133232311233213123132322444400000000000000000000000000000
00000000000000000000000000044123331133123333123232231112112333132223322222213131322331233211212321211111313121121313121400000000000000000000000000000
00000000000000000000000000004411331123333131322111133222213212131133111221212121233131232212131122231331311323312111312434400000000000000000000000000
00000000000000000000000000000444211213123332111323313232132133232333111312212311323213321311112211121122213232211123322444400000000000000000000000000
00000000000000000000000000000004432223333113121333132131112132221113232211233323332323331111213233122121322211223213332234400000000000000000000000000
00000000000000000000000000000004421212231113133111223133131333211232322132233232222311333322212211222211112223322311133344400000000000000000000000000
00000000000000000000000000000000441231221232212122123312112321123121131213133123333312333133311222221113121313123212311244440000000000000000000000000
00000000000000000000000000000000044321111212331322313311221121231332321212212322311131132333232332322312123111122213223244440000000000000000000000000
00000000000000000000000000000000004421122331211221323111121232123213232112122121232133231132322112223111211331112132213114444000000000000000000000000
00000000000000000000000000000000004131313211113332313331311222211132221111221233131131133133212122131223233121322121111414440400000000000000000000000
00000000000000000000000000000000000044121111111231221333322331221212211111133133113132332321311231222233312332332221333244444400000000000000000000000
00000000000000000000000000000000000044421233322212123123132121333333313132231122333313321222111331113213232322112232322244440400000000000000000000000
00000000000000000000000000000000000000441223112323223331323213312231322313121331331113311322212132212132113131111121222312444000000000000000000000000
00000000000000000000000000000000000000044113332331112213211323321121231222321211131113121133131322321332232113321323322144444400000000000000000000000
00000000000000000000000000000000000000004432213331222311113212231321223131131332232212133122223211323323121311132111113144444400000000000000000000000
00000000000000000000000000000000000000004442231322311323131331113212323213331221121111122123212122331312233333132311213214444400000000000000000000000
00000000000000000000000000000000000000000444121321213312312323313322232333111322231133131121223232132212311123111122323314444400000000000000000000000
00000000000000000000000000000000000000000044412122111133131311122321311321311333231311113313121333113321332221113111121244444000000000000000000000000
00000000000000000000000000000000000000000000444231311231323333212112223323233111331131322232133223233233233233113313213443100000000000000000000000000
00000000000000000000000000000000000000000000044441232321213113131112332113331113211211313332113121122133212232313332344411000000000000000000000000000
00000000000000000000000000000000000000000000004443231322321322321123112112212233211112133213321323312222312221332134444302000000000000000000000000000
00000000000000000000000000000000000000000000000444344112313231222122312313211112333122313313323212313313313321332244440000000000000000000000000000000
00000000000000000000000000000000000000000000000000444431133122122131312323123133331213313133123322233111321122144434000000000000000000000000000000000
00000000000000000000000000000000000000000000000000044444443441212231221211113221133333321323333321224444444444444400000000000000000000000000000000000
00000000000000000000000000000000000000000000000000000000444444444444444444444444444444444444444444440000000000000000000000000000000000000000000000000
00000000000000000000000000000000000000000000000000000000000000444444444444444444444444444444444000000000000000000000000000000000000000000000000000000
00000000000000000000000000000000000000000000000000000000000000000000000000000000000000000000000000000000000000000000000000000000000000000000000000000
00000000000000000000000000000000000000000000000000000000000000000000000000000000000000000000000000000000000000000000000000000000000000000000000000000
00000000000000000000000000000000000000000000000000000000000000000000000000000000000000000000000000000000000000000000000000000000000000000000000000000
00000000000000000000000000000000000000000000000000000000000000000000000000000000000000000000000000000000000000000000000000000000000000000000000000000
00000000000000000000000000000000000000000000000000000000000000000000000000000000000000000000000000000000000000000000000000000000000000000000000000000
