00000000000000000000000000000000000000000000000000000000000000000000000000000000000000000000000000000000000000000000000000000000000000000000000000000
00000000000000000000000000000000000000000000000000000000000000000000000000000000000000000000000000000000000000000000000000000000000000000000000000000
00000000000000000000000000000000000000000000000000000000000000000000000000000000000000000000000000000000000000000000000000000000000000000000000000000
00000000000000000000000000000000000000000000000000000000000000000000000000000000000000000000000000000000000000000000000000000000000000000000000000000
00000000000000000000000000000000000000000000000000000000000000000000000000000000000000000000000000000000000000000000000000000000000000000000000000000
00000000000000000000000000000000000000000000000000000000000000000000000000000000000000000000000000000000000000000000000000000000000000000000000000000
00000000000000000000000000000000000000000000000000000000000000000000000000000000000000000000000000000000000000000000000000000000000000000000000000000
00000000000000000000000000000000000000000000000000000000000000000000000000000000000000000000000000000000000000000000000000000000000000000000000000000
00000000000000000000044444444444444444444444444444444444444444444444444444444444444444444444444444444444444000000000000000000000000000000000000000000
00000000000000000044444213121121332211112212213233231322212331331332211331121132221112213312121313221313232400000000000000000000000000000000000000000
00000000000000000444323121322221211223121311112311313212122321321121111221221132133323123322131331323321322440000000000000000000000000000000000000000
00000000000000000413312111233111333133213213232211313321213213122111131122322132321113331132222333211222132244000000000000000000000000000000000000000
00000000000000000433332121121211312223122131113311223132331231211323323333323213332132232112322322123121311314440000000000000000000000000000000000000
00000000000000000423233312313132131222322123321323132131212333112222131322211332212332311321312321323213121324444000000000000000000000000000000000000
00000000000000000044222133131332322221333232123321333223323312333123313111113232121121113322122113211111232231444400000000000000000000000000000000000
00000000000000000044123121323123133331212233331212111221223332121132213112122323313331211112132313313133231112344440000000000000000000000000000000000
00000000000000000000413313112231321113131211333131112313233321222331323223133323323322221323111222313312111123233240000000000000000000000000000000000
00000000000000000000032322312311131312233132322312313333223222232232121332222232213233313223113213223232311323313144000000000000000000000000000000000
00000000000000000000001211231132122222111312232131232331321331131221211323133112213312221313331123322233331112223444400000000000000000000000000000000
00000000000000000000000422223112133312333311331133311213232331233232123333123111121123121322222211211231133112322344440000000000000000000000000000000
00000000000000000000000041132132211221133323133113212322131333221323332113312132112132332112311231121312112211332144444000000000000000000000000000000
00000000000000000000000004332122312333122212131233331212212133311231312121322221112331221111112122122213233121333324444000000000000000000000000000000
00000000000000000000000000442123233233323111122321121331231311232222132232213122223123211313331313132211321221213331444400000000000000000000000000000
00000000000000000000000000043122322223212313221222213222112133223321232222221333122222211121232333223322312131322233444400000000000000000000000000000
00000000000000000000000000044233112213121211131312123312323123113123212231332111321112311113113311123312221131121333323400000000000000000000000000000
00000000000000000000000000004423212332231323221222232312213213131113211221111131122221113331213112223211131332223233323424400000000000000000000000000
00000000000000000000000000000444332223321332221311123131323223111231111133323221222232213333333213213221121113313332213444400000000000000000000000000
00000000000000000000000000000004422333121122211323322313122232231233213331323312113232222113131112133321211311323222131214400000000000000000000000000
00000000000000000000000000000004412321313113332213232121221222312333223321132232123233133213111223213211221131223132132344400000000000000000000000000
00000000000000000000000000000000442223133321231322233111321222223322111213211112123222331313232113333232132231332223112344440000000000000000000000000
00000000000000000000000000000000044211122232221322122321113332212312313131323211222333321331232113122233221121123332111244440000000000000000000000000
00000000000000000000000000000000004423333323211332111232131223312213223221113131212321231133213223221121133123111213321124444000000000000000000000000
00000000000000000000000000000000004112123313232322121331211222122322233332121111133131212123321211131232133121331131232424440400000000000000000000000
00000000000000000000000000000000000044332213231131321213222211223331212133121321122132333323112122121211122121212212313244444400000000000000000000000
00000000000000000000000000000000000044432122132321323333131232223211123122322131131323312212112213323312132232332232233244440400000000000000000000000
00000000000000000000000000000000000000442132132231133122311312111322323321213233111311212223123132233123332233313323221333444000000000000000000000000
00000000000000000000000000000000000000044332212212312321323322122112333212132331321133231121311333311213131112213313323344444400000000000000000000000
00000000000000000000000000000000000000004423111333233331321212312121312131223231131111313233331323232223213132312213311244444400000000000000000000000
00000000000000000000000000000000000000004443132222233121113211211123113323232123333222113311212332113222213331313313233334444400000000000000000000000
00000000000000000000000000000000000000000444122232112333133313133231133223133212321331322131333122313332113313131232313224444400000000000000000000000
00000000000000000000000000000000000000000044422111322211312332212332121331111123213233321332132131312232321112131311123344444000000000000000000000000
00000000000000000000000000000000000000000000444232232332232221332132332223221312213121313131233212333323233132311212111442300000000000000000000000000
00000000000000000000000000000000000000000000044443232111223312111221132123111313213121221212322122113223112223331112144432000000000000000000000000000
00000000000000000000000000000000000000000000004442223212221322211232132233212123132211133133213333221333313111313314444301000000000000000000000000000
00000000000000000000000000000000000000000000000444244311233211133321211112232323121121132113322311111221213312233144440000000000000000000000000000000
00000000000000000000000000000000000000000000000000444432121311123232131322131213131311122132133311112211212332144434000000000000000000000000000000000
00000000000000000000000000000000000000000000000000044444443441322222112232312322311113322331222123134444444444444400000000000000000000000000000000000
00000000000000000000000000000000000000000000000000000000444444444444444444444444444444444444444444440000000000000000000000000000000000000000000000000
00000000000000000000000000000000000000000000000000000000000000444444444444444444444444444444444000000000000000000000000000000000000000000000000000000
00000000000000000000000000000000000000000000000000000000000000000000000000000000000000000000000000000000000000000000000000000000000000000000000000000
00000000000000000000000000000000000000000000000000000000000000000000000000000000000000000000000000000000000000000000000000000000000000000000000000000
00000000000000000000000000000000000000000000000000000000000000000000000000000000000000000000000000000000000000000000000000000000000000000000000000000
00000000000000000000000000000000000000000000000000000000000000000000000000000000000000000000000000000000000000000000000000000000000000000000000000000
00000000000000000000000000000000000000000000000000000000000000000000000000000000000000000000000000000000000000000000000000000000000000000000000000000
