0303010102010202
0203020201010101
0302020102020301
0201010203020202
0103030303020301
0101010101020302
0201020103010303
0303030303010302
