   00000000000000000000000000000000000000000000000000000000000000000000000000000000000000000000000000000000000000000000000000000000000000000000000000000
   00000000000000000000000000000000000000000000000000000000000000000000000000000000000000000000000000000000000000000000000000000000000000000000000000000
   00000000000000000000000000000000000000000000000000000000000000000000000000000000000000000000000000000000000000000000000000000000000000000000000000000
   00000000000000000000000000000000000000000000000000000000000000000000000000000000000000000000000000000000000000000000000000000000000000000000000000000
   00000000000000000000000000000000000000000000000000000000000000000000000000000000000000000000000000000000000000000000000000000000000000000000000000000
   00000000000000000000000000000000000000000000000000000000000000000000000000000000000000000000000000000000000000000000000000000000000000000000000000000
   00000000000000000000000000000000000000000000000000000000000000000000000000000000000000000000000000000000000000000000000000000000000000000000000000000
   00000000000000000000000000000000000000000000000000000000000000000000000000000000000000000000000000000000000000000000000000000000000000000000000000000
   00000000000000000000044444444444444444444444444444444444444444444444444444444444444444444444444444444444444000000000000000000000000000000000000000000
   00000000000000000044444111111111111111111111111111111111111111111111111111111111111111111111111111111111111400000000000000000000000000000000000000000
   00000000000000000444111111111111111111111111111111111111111111111111111111111111111111111111111111111111111440000000000000000000000000000000000000000
   00000000000000000411111111111111111111111111111111111111111111111111111111111111111111111111111111111111111144000000000000000000000000000000000000000
   00000000000000000411111111111111111111111111111111111111111111111111111111111111111111111111111111111111111114440000000000000000000000000000000000000
   00000000000000000411111111111111111111111111111111111111111111111111111111111111111111111111111111111111111114444000000000000000000000000000000000000
   00000000000000000044111111111111111111111111111111111111111111111111111111111111111111111111111111111111111111444400000000000000000000000000000000000
   00000000000000000044111111111111111111111111111111111111111111111111111111111111111111111111111111111111111111144440000000000000000000000000000000000
   00000000000000000000411111111111111111111111111111111111111111111111111111111111111111111111111111111111111111111140000000000000000000000000000000000
   00000000000000000000011111111111111111111111111111111111111111111111111111111111111111111111111111111111111111111144000000000000000000000000000000000
   00000000000000000000001111111111111111111111111111111111111111111111111111111111111111111111111111111111111111111444400000000000000000000000000000000
   00000000000000000000000411111111111111111111111111111111111111111111111111111111111111111111111111111111111111111144440000000000000000000000000000000
   00000000000000000000000041111111111111111111111111111111111111111111111111111111111111111111111111111111111111111144444000000000000000000000000000000
   00000000000000000000000004111111111111111111111111111111111111111111111111111111111111111111111111111111111111111114444000000000000000000000000000000
   00000000000000000000000000441111111111111111111111111111111111111111111111111111111111111111111111111111111111111111444400000000000000000000000000000
   00000000000000000000000000041111111111111111111111111111111111111111111111111111111111111111111111111111111111111111444400000000000000000000000000000
   00000000000000000000000000044111111111111111111111111111111111111111111111111111111111111111111111111111111111111111111400000000000000000000000000000
   00000000000000000000000000004411111111111111111111111111111111111111111111111111111111111111111111111111111111111111111414400000000000000000000000000
   00000000000000000000000000000444111111111111111111111111111111111111111111111111111111111111111111111111111111111111111444400000000000000000000000000
   00000000000000000000000000000004411111111111111111111111111111111111111111111111111111111111111111111111111111111111111114400000000000000000000000000
   00000000000000000000000000000004411111111111111111111111111111111111111111111111111111111111111111111111111111111111111144400000000000000000000000000
   00000000000000000000000000000000441111111111111111111111111111111111111111111111111111111111111111111111111111111111111144440000000000000000000000000
   00000000000000000000000000000000044111111111111111111111111111111111111111111111111111111111111111111111111111111111111144440000000000000000000000000
   00000000000000000000000000000000004411111111111111111111111111111111111111111111111111111111111111111111111111111111111114444000000000000000000000000
   00000000000000000000000000000000004111111111111111111111111111111111111111111111111111111111111111111111111111111111111414440400000000000000000000000
   00000000000000000000000000000000000044111111111111111111111111111111111111111111111111111111111111111111111111111111111144444400000000000000000000000
   00000000000000000000000000000000000044411111111111111111111111111111111111111111111111111111111111111111111111111111111144440400000000000000000000000
   00000000000000000000000000000000000000441111111111111111111111111111111111111111111111111111111111111111111111111111111111444000000000000000000000000
   00000000000000000000000000000000000000044111111111111111111111111111111111111111111111111111111111111111111111111111111144444400000000000000000000000
   00000000000000000000000000000000000000004411111111111111111111111111111111111111111111111111111111111111111111111111111144444400000000000000000000000
   00000000000000000000000000000000000000004441111111111111111111111111111111111111111111111111111111111111111111111111111114444400000000000000000000000
   00000000000000000000000000000000000000000444111111111111111111111111111111111111111111111111111111111111111111111111111114444400000000000000000000000
   00000000000000000000000000000000000000000044411111111111111111111111111111111111111111111111111111111111111111111111111144444000000000000000000000000
   00000000000000000000000000000000000000000000444111111111111111111111111111111111111111111111111111111111111111111111111441100000000000000000000000000
   00000000000000000000000000000000000000000000044441111111111111111111111111111111111111111111111111111111111111111111144411000000000000000000000000000
   00000000000000000000000000000000000000000000004441111111111111111111111111111111111111111111111111111111111111111114444101000000000000000000000000000
   00000000000000000000000000000000000000000000000444144111111111111111111111111111111111111111111111111111111111111144440000000000000000000000000000000
   00000000000000000000000000000000000000000000000000444411111111111111111111111111111111111111111111111111111111144414000000000000000000000000000000000
   00000000000000000000000000000000000000000000000000044444441441111111111111111111111111111111111111114444444444444400000000000000000000000000000000000
   00000000000000000000000000000000000000000000000000000000444444444444444444444444444444444444444444440000000000000000000000000000000000000000000000000
   00000000000000000000000000000000000000000000000000000000000000444444444444444444444444444444444000000000000000000000000000000000000000000000000000000
   00000000000000000000000000000000000000000000000000000000000000000000000000000000000000000000000000000000000000000000000000000000000000000000000000000
   00000000000000000000000000000000000000000000000000000000000000000000000000000000000000000000000000000000000000000000000000000000000000000000000000000
   00000000000000000000000000000000000000000000000000000000000000000000000000000000000000000000000000000000000000000000000000000000000000000000000000000
   00000000000000000000000000000000000000000000000000000000000000000000000000000000000000000000000000000000000000000000000000000000000000000000000000000
   00000000000000000000000000000000000000000000000000000000000000000000000000000000000000000000000000000000000000000000000000000000000000000000000000000