00000000000000000000000000000000000000000000000000000000000000000000000000000000000000000000000000000000000000000000000000000000000000000000000000000
00000000000000000000000000000000000000000000000000000000000000000000000000000000000000000000000000000000000000000000000000000000000000000000000000000
00000000000000000000000000000000000000000000000000000000000000000000000000000000000000000000000000000000000000000000000000000000000000000000000000000
00000000000000000000000000000000000000000000000000000000000000000000000000000000000000000000000000000000000000000000000000000000000000000000000000000
00000000000000000000000000000000000000000000000000000000000000000000000000000000000000000000000000000000000000000000000000000000000000000000000000000
00000000000000000000000000000000000000000000000000000000000000000000000000000000000000000000000000000000000000000000000000000000000000000000000000000
00000000000000000000000000000000000000000000000000000000000000000000000000000000000000000000000000000000000000000000000000000000000000000000000000000
00000000000000000000000000000000000000000000000000000000000000000000000000000000000000000000000000000000000000000000000000000000000000000000000000000
00000000000000000000044444444444444444444444444444444444444444444444444444444444444444444444444444444444444000000000000000000000000000000000000000000
00000000000000000044444322121332212212331122221311233132332122112332333313121313231311223311211123312113213400000000000000000000000000000000000000000
00000000000000000444311111121313323231232222111222111213221212211131123311213321131132232221321321131332221440000000000000000000000000000000000000000
00000000000000000413332221111112323311232111213313311111122113311322332312221213221122221132333323221323313344000000000000000000000000000000000000000
00000000000000000431323231322333333212222132323313231311212111212323133221321131222213213212123312121121333324440000000000000000000000000000000000000
00000000000000000413332312232223213321223232123322332332112232122132221222123132223222131112221121312123232124444000000000000000000000000000000000000
00000000000000000044122221311122111121311121132233311122233211231321131322321131322112322321332213232321113212444400000000000000000000000000000000000
00000000000000000044122322112131313212333122322311231232333221223311221111222112322132131232322321131212121123244440000000000000000000000000000000000
00000000000000000000411121313313213111231232322322223132122133121212132122221322223232333121311332233333131132312240000000000000000000000000000000000
00000000000000000000023212132133322311121111133312123331213333221333213322231113222221211131312121221113222132231244000000000000000000000000000000000
00000000000000000000001231222121232113113123223221322133322222322312332121213211331123211112322232133312223311213444400000000000000000000000000000000
00000000000000000000000411212131312322221213113212323323213212221332212332313113132321123332133233331212311111123244440000000000000000000000000000000
00000000000000000000000042123322333313113123213333313332122133321212321223323313222223331233112313332231311321332144444000000000000000000000000000000
00000000000000000000000004232312131132111212313132121332131221123212221211312323321311313323132132231123333232213234444000000000000000000000000000000
00000000000000000000000000442131331331112313113313122113133131333232222113321113132113223331122323333323232133311213444400000000000000000000000000000
00000000000000000000000000041122322323113221233131232321332213121222123123131111212223132133112121111211113313132312444400000000000000000000000000000
00000000000000000000000000044111213312213112223321123221122331212211222222322132112333111211133121132121311131333213213400000000000000000000000000000
00000000000000000000000000004431221213123212312311322121313113332213221233112221232211123222322133213122121222332121123434400000000000000000000000000
00000000000000000000000000000444232133232213313233232233313231122122132333112313123332312211313232121232233232213123121444400000000000000000000000000
00000000000000000000000000000004432331213113121221322222222333131221231123312313131111133222322121121322133113112132213324400000000000000000000000000
00000000000000000000000000000004432122233313211212322232112122312131213312131222121121221221311112112323233212121331112244400000000000000000000000000
00000000000000000000000000000000441213313122122232222333123233311122313223113232331221311131332322311231133211133312332244440000000000000000000000000
00000000000000000000000000000000044332321113333313311311111211121132222132231221313122211332321113213112232232332231313144440000000000000000000000000
00000000000000000000000000000000004423122322221123122211112133231321212333323222133323331113313131131122111112223233312234444000000000000000000000000
00000000000000000000000000000000004222313223312312123123321322322113111311132122113333322223231212123113222321123211211434440400000000000000000000000
00000000000000000000000000000000000044322111133322121313222331212332211313113111132333332222223122312323312332322123213244444400000000000000000000000
00000000000000000000000000000000000044423111112231131332322211123113331111322323312122111213211112212231233223322232313344440400000000000000000000000
00000000000000000000000000000000000000441333313313333332113113233313322221113221211211332231111231223111313312213123121212444000000000000000000000000
00000000000000000000000000000000000000044122331321232222322322321312311321323223331122123331223323323331123312212131113244444400000000000000000000000
00000000000000000000000000000000000000004412133311112233221112132133133233122111232322333111321122112321221323113313113144444400000000000000000000000
00000000000000000000000000000000000000004441133323321112323322131111321323121331122222222223311211122121231223113322122114444400000000000000000000000
00000000000000000000000000000000000000000444322312321211122113212221122233311223221112311123112332221223323131321313133234444400000000000000000000000
00000000000000000000000000000000000000000044431121332331331121331111212313123122122231332211121131113231231211331331131144444000000000000000000000000
00000000000000000000000000000000000000000000444223132213131311232121313111323321112233211231223333222323231331121221331441300000000000000000000000000
00000000000000000000000000000000000000000000044442232212223331233313232113123311121113112111311321333322111311231111144411000000000000000000000000000
00000000000000000000000000000000000000000000004442311313211331321332121131133112221213331211311311212112312321113314444102000000000000000000000000000
00000000000000000000000000000000000000000000000444144232332322233231132113133132212133322312331313123121323113322144440000000000000000000000000000000
00000000000000000000000000000000000000000000000000444433321213321111332223332233323132223123211121132332233112344414000000000000000000000000000000000
00000000000000000000000000000000000000000000000000044444442441333231123213133212222132333233213322324444444444444400000000000000000000000000000000000
00000000000000000000000000000000000000000000000000000000444444444444444444444444444444444444444444440000000000000000000000000000000000000000000000000
00000000000000000000000000000000000000000000000000000000000000444444444444444444444444444444444000000000000000000000000000000000000000000000000000000
00000000000000000000000000000000000000000000000000000000000000000000000000000000000000000000000000000000000000000000000000000000000000000000000000000
00000000000000000000000000000000000000000000000000000000000000000000000000000000000000000000000000000000000000000000000000000000000000000000000000000
00000000000000000000000000000000000000000000000000000000000000000000000000000000000000000000000000000000000000000000000000000000000000000000000000000
00000000000000000000000000000000000000000000000000000000000000000000000000000000000000000000000000000000000000000000000000000000000000000000000000000
00000000000000000000000000000000000000000000000000000000000000000000000000000000000000000000000000000000000000000000000000000000000000000000000000000
