00000000000000000000000000000000000000000000000000000000000000000000000000000000000000000000000000000000000000000000000000000000000000000000000000000
00000000000000000000000000000000000000000000000000000000000000000000000000000000000000000000000000000000000000000000000000000000000000000000000000000
00000000000000000000000000000000000000000000000000000000000000000000000000000000000000000000000000000000000000000000000000000000000000000000000000000
00000000000000000000000000000000000000000000000000000000000000000000000000000000000000000000000000000000000000000000000000000000000000000000000000000
00000000000000000000000000000000000000000000000000000000000000000000000000000000000000000000000000000000000000000000000000000000000000000000000000000
00000000000000000000000000000000000000000000000000000000000000000000000000000000000000000000000000000000000000000000000000000000000000000000000000000
00000000000000000000000000000000000000000000000000000000000000000000000000000000000000000000000000000000000000000000000000000000000000000000000000000
00000000000000000000000000000000000000000000000000000000000000000000000000000000000000000000000000000000000000000000000000000000000000000000000000000
00000000000000000000044444444444444444444444444444444444444444444444444444444444444444444444444444444444444000000000000000000000000000000000000000000
00000000000000000044444311332231332133333122331311333112312313323221212112233211121123112322332233133333221400000000000000000000000000000000000000000
00000000000000000444312122132321112112231113223113222232121212221212123321122113322222223222232311232221233440000000000000000000000000000000000000000
00000000000000000422233212213321131211113231331131223211133123223232322313123112222121331332221231233233311344000000000000000000000000000000000000000
00000000000000000413231333223331111223323212311332322233112232323223213313323233122231322131331132212222323334440000000000000000000000000000000000000
00000000000000000412311232233313321121311213112223121322312233232133223211231121112311111231121121113221313224444000000000000000000000000000000000000
00000000000000000044131331333312111333121321232322223112213212311322211311221222213113122232133122232332121211444400000000000000000000000000000000000
00000000000000000044222111322113333132322332112133323223121132123212322121132331323131322222212122112322213231144440000000000000000000000000000000000
00000000000000000000423222122221123121333322313313211222123232333313211133113313131211233211221212122222211133112340000000000000000000000000000000000
00000000000000000000011322322211322111131122231333123331131223111233213333123113333311311112333122312331111123231244000000000000000000000000000000000
00000000000000000000003112132111333221132112111311213132331233211133321213212323313321122212331131121122132321132444400000000000000000000000000000000
00000000000000000000000423221311122313222211222232111111131333133131112223223122311313211333221121132331122132221144440000000000000000000000000000000
00000000000000000000000043133131122233131232212121132232333221121212131222132211131321132221113112222323233232121344444000000000000000000000000000000
00000000000000000000000004232312233211121333123222132112233333321122331332131321112222232231111223121323313321223224444000000000000000000000000000000
00000000000000000000000000443221132221133213313131313132332111231123212313132121123112313121331323123112211312221111444400000000000000000000000000000
00000000000000000000000000042122312112222211113332113232123211112111211113233111111211331112332211122223112123323332444400000000000000000000000000000
00000000000000000000000000044323322311113211132331333121221132113211223111232212322213321133121332322312131223133312221400000000000000000000000000000
00000000000000000000000000004411112212331113112222221223132213311211232123233322111311312323212223231331323231211312331414400000000000000000000000000
00000000000000000000000000000444233213111321311122323221133133133333223331323333333233323312333133312122212131322213323444400000000000000000000000000
00000000000000000000000000000004421311311232222221212223233311231211223222333113313232232232113321313122223222121112333214400000000000000000000000000
00000000000000000000000000000004431322211313123313331323221321113132122121113131232313331232113211333223112323131111133244400000000000000000000000000
00000000000000000000000000000000442111122132332313212311213122122322211121133211232233331333121321333333311223113223231344440000000000000000000000000
00000000000000000000000000000000044221131322122122133211123321113122223132221132231131313332222111213221122213221123232244440000000000000000000000000
00000000000000000000000000000000004422312321212231112221323231132221321133232111223332131223211212123223112332113213312114444000000000000000000000000
00000000000000000000000000000000004323122112131221232312322223232333212112113322212232133332211221312323323123312233331434440400000000000000000000000
00000000000000000000000000000000000044312213332313312131232331122213222132322112211222221321131121131112223323132212121344444400000000000000000000000
00000000000000000000000000000000000044432233232321322331322132131223133322121313122111212312332121233132132111111121211144440400000000000000000000000
00000000000000000000000000000000000000442121333112211211221112133222213233121123312111213311113233311121233123121311313232444000000000000000000000000
00000000000000000000000000000000000000044332132211111233331221212211133122331121311312211221133323133213123222222322213344444400000000000000000000000
00000000000000000000000000000000000000004422223132131123232231233123111333113322121122112112312133112131112331133112323244444400000000000000000000000
00000000000000000000000000000000000000004443223233121322211121321211323123123311231323313312213212222122133322121111112334444400000000000000000000000
00000000000000000000000000000000000000000444312121321321333221332111322321111113231231311212231223211312113133232231311114444400000000000000000000000
00000000000000000000000000000000000000000044421221313312331331313113121223232132122232113132323122231321222121222231221344444000000000000000000000000
00000000000000000000000000000000000000000000444122322313211221211323331331323133232313232122331132112223323113133311312443100000000000000000000000000
00000000000000000000000000000000000000000000044441231211233131113331212233221312123221313133132123113212331121112122244422000000000000000000000000000
00000000000000000000000000000000000000000000004442312211331133221133121322121211312132321121223321332122213322113114444101000000000000000000000000000
00000000000000000000000000000000000000000000000444344332322113232313131213213111132312123323111122133212312313332144440000000000000000000000000000000
00000000000000000000000000000000000000000000000000444421221313312322212323313122222133213322311211211121213213344424000000000000000000000000000000000
00000000000000000000000000000000000000000000000000044444441443322222322122233232213321323332232112134444444444444400000000000000000000000000000000000
00000000000000000000000000000000000000000000000000000000444444444444444444444444444444444444444444440000000000000000000000000000000000000000000000000
00000000000000000000000000000000000000000000000000000000000000444444444444444444444444444444444000000000000000000000000000000000000000000000000000000
00000000000000000000000000000000000000000000000000000000000000000000000000000000000000000000000000000000000000000000000000000000000000000000000000000
00000000000000000000000000000000000000000000000000000000000000000000000000000000000000000000000000000000000000000000000000000000000000000000000000000
00000000000000000000000000000000000000000000000000000000000000000000000000000000000000000000000000000000000000000000000000000000000000000000000000000
00000000000000000000000000000000000000000000000000000000000000000000000000000000000000000000000000000000000000000000000000000000000000000000000000000
00000000000000000000000000000000000000000000000000000000000000000000000000000000000000000000000000000000000000000000000000000000000000000000000000000
