0201020203030202
0301020301020303
0103010202020103
0202010203030201
0302020101010203
0101020102030203
0103030302030201
0303020202020202
