0103010201010102
0301030201030203
0302030203020103
0102010302030103
0201030202030101
0103010303030302
0303030302020203
0203030101020101
