00000000000000000000000000000000000000000000000000000000000000000000000000000000000000000000000000000000000000000000000000000000000000000000000000000
00000000000000000000000000000000000000000000000000000000000000000000000000000000000000000000000000000000000000000000000000000000000000000000000000000
00000000000000000000000000000000000000000000000000000000000000000000000000000000000000000000000000000000000000000000000000000000000000000000000000000
00000000000000000000000000000000000000000000000000000000000000000000000000000000000000000000000000000000000000000000000000000000000000000000000000000
00000000000000000000000000000000000000000000000000000000000000000000000000000000000000000000000000000000000000000000000000000000000000000000000000000
00000000000000000000000000000000000000000000000000000000000000000000000000000000000000000000000000000000000000000000000000000000000000000000000000000
00000000000000000000000000000000000000000000000000000000000000000000000000000000000000000000000000000000000000000000000000000000000000000000000000000
00000000000000000000000000000000000000000000000000000000000000000000000000000000000000000000000000000000000000000000000000000000000000000000000000000
00000000000000000000044444444444444444444444444444444444444444444444444444444444444444444444444444444444444000000000000000000000000000000000000000000
00000000000000000044444233323333333323123112121313123312212312231222133223323132233211321113233233333122332400000000000000000000000000000000000000000
00000000000000000444211231332313212121133311132111323332322221223132113222122213123113233323222111133131223440000000000000000000000000000000000000000
00000000000000000412213323311112233132323231131113111212213332121322331233312231313233332313122212311131211144000000000000000000000000000000000000000
00000000000000000412122311211213111333333113132212213231321312121231113333312213122313122231211112232131323114440000000000000000000000000000000000000
00000000000000000432211221233323232132133233212222111311231213121313322322332331223122323312221212233223211114444000000000000000000000000000000000000
00000000000000000044312322223122323311133233122323212121132312221111321131233131221111211233122113113123111222444400000000000000000000000000000000000
00000000000000000044123123121211223222331333121222322223131112123133122323322112132312233112131332323113231222344440000000000000000000000000000000000
00000000000000000000423121311321123311112132122133211333132311112133113211213113233131123231311122321233232211212340000000000000000000000000000000000
00000000000000000000013222223221123112223322223331123113322212223311232313321121123322312322223232113323331323122144000000000000000000000000000000000
00000000000000000000001313131221331332312132122112322131131131313113112133313321133113212322231323233113331222313444400000000000000000000000000000000
00000000000000000000000412313232212222121311313212331133131313311313221121313133311131312313133212233313123312331344440000000000000000000000000000000
00000000000000000000000042213111321122113333332321332111221333333113312213321332311332123232231121231123311332332144444000000000000000000000000000000
00000000000000000000000004321331211113223231212321121221231121223332321232113232213132131131111123231323331122222124444000000000000000000000000000000
00000000000000000000000000442313132221112222112122211313211231221322212113232112122322333331332133322132323233331211444400000000000000000000000000000
00000000000000000000000000042211233311111132112321313133112233113333122113213111323311313122133232332313232213332121444400000000000000000000000000000
00000000000000000000000000044313311333231323211212133212231322312322313232122213122113213211323233123131113323132323212400000000000000000000000000000
00000000000000000000000000004423212321331332122112231133113122113122132122131333221122331122333332231331132113123222332434400000000000000000000000000
00000000000000000000000000000444323111123333223332312112223322111311121211212331231323331123312212221211132122322233121444400000000000000000000000000
00000000000000000000000000000004411331121231232213131221132321231322311331313311231312222312231212233311332112233221132214400000000000000000000000000
00000000000000000000000000000004422212113122222121121132222121111331113313321311213312221311122211113323213121113231211344400000000000000000000000000
00000000000000000000000000000000442211222232132333123133231222113211211322331331232312223332121222331222212112331312212144440000000000000000000000000
00000000000000000000000000000000044332333233333313222121221322222133331333131231311123333113313333121223231333313131311244440000000000000000000000000
00000000000000000000000000000000004421313213321323313133133333222231223221223331322313231232132223131231322122212112321224444000000000000000000000000
00000000000000000000000000000000004123313113122332332131122213323131211333232333331111312312231321113212112323122212133424440400000000000000000000000
00000000000000000000000000000000000044212222133332323211311233122323323323233223332331111321113122121132232331333333322144444400000000000000000000000
00000000000000000000000000000000000044423222122322232213112323222211232311112213111132232222313311312323322221121111312244440400000000000000000000000
00000000000000000000000000000000000000442212232323313111122333132331322113331132331322312133213321133132111211222312331222444000000000000000000000000
00000000000000000000000000000000000000044311312233131322231223222322311231313212131231232221323212132312132132223232132344444400000000000000000000000
00000000000000000000000000000000000000004413131112121133213213321211112222233132113213131322223311213222123112123221212344444400000000000000000000000
00000000000000000000000000000000000000004441231333123321213222111322331231132121131112312321321231131111112222322323112114444400000000000000000000000
00000000000000000000000000000000000000000444223111212112111212131221113213122333321112213212321131233112111311222123131134444400000000000000000000000
00000000000000000000000000000000000000000044432211111313121131222123323233121313233133223232232133122331333112233313323244444000000000000000000000000
00000000000000000000000000000000000000000000444312122313113222221311133121331322212321121333321233232222231232232331232441200000000000000000000000000
00000000000000000000000000000000000000000000044442121311322322332313311133332111312132223333321332223212213123111112144423000000000000000000000000000
00000000000000000000000000000000000000000000004442131122212323122332321323123223321312232212112332223112221121311314444201000000000000000000000000000
00000000000000000000000000000000000000000000000444244313122212322323311132232121232112313233122123333331333313323344440000000000000000000000000000000
00000000000000000000000000000000000000000000000000444411332133321221322221222332113211322122132133332321312212244424000000000000000000000000000000000
00000000000000000000000000000000000000000000000000044444441441133111232111121131123123331213223121134444444444444400000000000000000000000000000000000
00000000000000000000000000000000000000000000000000000000444444444444444444444444444444444444444444440000000000000000000000000000000000000000000000000
00000000000000000000000000000000000000000000000000000000000000444444444444444444444444444444444000000000000000000000000000000000000000000000000000000
00000000000000000000000000000000000000000000000000000000000000000000000000000000000000000000000000000000000000000000000000000000000000000000000000000
00000000000000000000000000000000000000000000000000000000000000000000000000000000000000000000000000000000000000000000000000000000000000000000000000000
00000000000000000000000000000000000000000000000000000000000000000000000000000000000000000000000000000000000000000000000000000000000000000000000000000
00000000000000000000000000000000000000000000000000000000000000000000000000000000000000000000000000000000000000000000000000000000000000000000000000000
00000000000000000000000000000000000000000000000000000000000000000000000000000000000000000000000000000000000000000000000000000000000000000000000000000
