0103020102010103
0201020103030202
0302030302020203
0303030303030203
0103020101020202
0201020303010202
0202010301030303
0101010303030202
