00000000000000000000000000000000000000000000000000000000000000000000000000000000000000000000000000000000000000000000000000000000000000000000000000000
00000000000000000000000000000000000000000000000000000000000000000000000000000000000000000000000000000000000000000000000000000000000000000000000000000
00000000000000000000000000000000000000000000000000000000000000000000000000000000000000000000000000000000000000000000000000000000000000000000000000000
00000000000000000000000000000000000000000000000000000000000000000000000000000000000000000000000000000000000000000000000000000000000000000000000000000
00000000000000000000000000000000000000000000000000000000000000000000000000000000000000000000000000000000000000000000000000000000000000000000000000000
00000000000000000000000000000000000000000000000000000000000000000000000000000000000000000000000000000000000000000000000000000000000000000000000000000
00000000000000000000000000000000000000000000000000000000000000000000000000000000000000000000000000000000000000000000000000000000000000000000000000000
00000000000000000000000000000000000000000000000000000000000000000000000000000000000000000000000000000000000000000000000000000000000000000000000000000
00000000000000000000044444444444444444444444444444444444444444444444444444444444444444444444444444444444444000000000000000000000000000000000000000000
00000000000000000044444111122122313121131213333111213121111312213231322123121312223213333313332233332213321400000000000000000000000000000000000000000
00000000000000000444231113321332312221112121311222232323233211131323121331213321313233211122313121321332123440000000000000000000000000000000000000000
00000000000000000433123232231212311113112222331212232132211131312213121122221231212132112322222311333231311244000000000000000000000000000000000000000
00000000000000000423331233212333222321221221322213323322222332323332211122111132232223221313311232322323222324440000000000000000000000000000000000000
00000000000000000413331131332133132123332331232313112313233231231332322332232113232332123232233132322322212334444000000000000000000000000000000000000
00000000000000000044232231121312211232332233222132333133311331321222231233321111313231113322312132221332223321444400000000000000000000000000000000000
00000000000000000044131231211331131212321213233211322132221113123222113322112111312211122212232213313112311331244440000000000000000000000000000000000
00000000000000000000423332211331112331321223321213113222112321321212133211131112333122331233123212223323312213111140000000000000000000000000000000000
00000000000000000000022333123313221223311223321133221122211121313313133131132312233211121212221323333332212312312144000000000000000000000000000000000
00000000000000000000003323221131223322112321222122233111321322213132321122332323121211333233212311322313132112122444400000000000000000000000000000000
00000000000000000000000413211323221212232312212213132333322312212212112333232322133321312312211123322132231223212244440000000000000000000000000000000
00000000000000000000000041313123111113312213332321211313212331133113331332232313111213122123131223332113122311322244444000000000000000000000000000000
00000000000000000000000004111212212222311312213321211123221332233233123223123131213133232122322322333333312323113334444000000000000000000000000000000
00000000000000000000000000443231132331321233321322232122132123313231333321211311212123122332332113123121113221131232444400000000000000000000000000000
00000000000000000000000000042113322311133113132323121222323131331313132131312332322122332231323231122231322313333312444400000000000000000000000000000
00000000000000000000000000044223321213133323131312233222122121231332212211221131211311223123333332111321232213131123312400000000000000000000000000000
00000000000000000000000000004421311121322113111331221233332132233121132311333113232231212123321322131212121133332121223434400000000000000000000000000
00000000000000000000000000000444213131321132331212112321333121213112232111231111313131113131133111133122311122221333212444400000000000000000000000000
00000000000000000000000000000004421121223233132112321312112221322333312111233132311121312232232321112231111233312322111324400000000000000000000000000
00000000000000000000000000000004431221323331232213331321111222322323121231122131322123133131131233132112212123123233331244400000000000000000000000000
00000000000000000000000000000000442113133132222122311231122111122232332221123322121133331212132121222221331112333311321344440000000000000000000000000
00000000000000000000000000000000044333333322311133111133111122111222232323321322213212232211222112332311132121122132221244440000000000000000000000000
00000000000000000000000000000000004432123212213223332221223111331312233111311321213221131132313231123212111222221111112114444000000000000000000000000
00000000000000000000000000000000004123131113132311332132313111233333221323131322213213311211111231333332321211133321231434440400000000000000000000000
00000000000000000000000000000000000044131131231332123232123211223223321331312222333312132112211222233221112112311113321144444400000000000000000000000
00000000000000000000000000000000000044432313333213113322333232113323133232222323121133333221312323331123313112213312312244440400000000000000000000000
00000000000000000000000000000000000000441133322121313133122313122313312112112233123112113223332231323133232113231333331312444000000000000000000000000
00000000000000000000000000000000000000044223333313122321223332111223313332223232312232332123123111122112212233112112222144444400000000000000000000000
00000000000000000000000000000000000000004423333323323122132322232232331112312123122132322113322131333112133132112313322144444400000000000000000000000
00000000000000000000000000000000000000004443323321112222132233123211312233311231313323132232122122122232213212223322312214444400000000000000000000000
00000000000000000000000000000000000000000444232333213332222111221333321312111223312212222212331211312223331231213121112224444400000000000000000000000
00000000000000000000000000000000000000000044422333131212232322221211113133122113322111212231112133121222321133331312213144444000000000000000000000000
00000000000000000000000000000000000000000000444222233213322123323123111321132323112212323212131213213211212123322132311443200000000000000000000000000
00000000000000000000000000000000000000000000044441323213321122132312121133132311321223211222232122121333122121132323344413000000000000000000000000000
00000000000000000000000000000000000000000000004443322131211213211332231221223321232331213211311331121311111311211114444103000000000000000000000000000
00000000000000000000000000000000000000000000000444344311121131123113211211132231212223323232313231312221211133212344440000000000000000000000000000000
00000000000000000000000000000000000000000000000000444421232123223331121312211132313113123221312312332333211333344424000000000000000000000000000000000
00000000000000000000000000000000000000000000000000044444442442232211121133132332213132212213232312114444444444444400000000000000000000000000000000000
00000000000000000000000000000000000000000000000000000000444444444444444444444444444444444444444444440000000000000000000000000000000000000000000000000
00000000000000000000000000000000000000000000000000000000000000444444444444444444444444444444444000000000000000000000000000000000000000000000000000000
00000000000000000000000000000000000000000000000000000000000000000000000000000000000000000000000000000000000000000000000000000000000000000000000000000
00000000000000000000000000000000000000000000000000000000000000000000000000000000000000000000000000000000000000000000000000000000000000000000000000000
00000000000000000000000000000000000000000000000000000000000000000000000000000000000000000000000000000000000000000000000000000000000000000000000000000
00000000000000000000000000000000000000000000000000000000000000000000000000000000000000000000000000000000000000000000000000000000000000000000000000000
00000000000000000000000000000000000000000000000000000000000000000000000000000000000000000000000000000000000000000000000000000000000000000000000000000
