00000000000000000000000000000000000000000000000000000000000000000000000000000000000000000000000000000000000000000000000000000000000000000000000000000
00000000000000000000000000000000000000000000000000000000000000000000000000000000000000000000000000000000000000000000000000000000000000000000000000000
00000000000000000000000000000000000000000000000000000000000000000000000000000000000000000000000000000000000000000000000000000000000000000000000000000
00000000000000000000000000000000000000000000000000000000000000000000000000000000000000000000000000000000000000000000000000000000000000000000000000000
00000000000000000000000000000000000000000000000000000000000000000000000000000000000000000000000000000000000000000000000000000000000000000000000000000
00000000000000000000000000000000000000000000000000000000000000000000000000000000000000000000000000000000000000000000000000000000000000000000000000000
00000000000000000000000000000000000000000000000000000000000000000000000000000000000000000000000000000000000000000000000000000000000000000000000000000
00000000000000000000000000000000000000000000000000000000000000000000000000000000000000000000000000000000000000000000000000000000000000000000000000000
00000000000000000000044444444444444444444444444444444444444444444444444444444444444444444444444444444444444000000000000000000000000000000000000000000
00000000000000000044444312222112222222111231323313221322121113122313311331322231221311132232232231323111313400000000000000000000000000000000000000000
00000000000000000444323112331222111211212232312322213332111233333131223231233223231213222233321222333113223440000000000000000000000000000000000000000
00000000000000000433232323221122112312332111332311133323323233312233331123331331321211321333333311232333312244000000000000000000000000000000000000000
00000000000000000421132221121312212223112233122311213222313213221311221321233222311331111232323222113131113234440000000000000000000000000000000000000
00000000000000000413212331123132312312321321322113311333312223331311333332131113212333132112113211122112323114444000000000000000000000000000000000000
00000000000000000044123231221221113221312221321212233121122232122231123323222332112133111212111312323122133332444400000000000000000000000000000000000
00000000000000000044322321332311213311123322121311323112212321112222311112331122222313112223212332121221313321344440000000000000000000000000000000000
00000000000000000000413131211111211331333332312123131112213313133221322111121232331311333231122211111112111112121340000000000000000000000000000000000
00000000000000000000031131113323113123222212231133112223211313333223212231332133333131132131331232331131212312111144000000000000000000000000000000000
00000000000000000000003211231311223222212122333221322122331311233222322323223222333233121332123331233133232213212444400000000000000000000000000000000
00000000000000000000000411212131113233233213232232111312113213311321131213221131212121312333333232313232122323212144440000000000000000000000000000000
00000000000000000000000041133323312112331322333321211232132212122123222133211331222313123232131332223211123123112144444000000000000000000000000000000
00000000000000000000000004113211233123312311133232113132113132212222212322331221111131332233111111231323133332111124444000000000000000000000000000000
00000000000000000000000000443312123111121221122231312131212212311212222311121132221111233122123333312333133232121311444400000000000000000000000000000
00000000000000000000000000041221211232211231323313233233221231133311222313131222122211211212311313221222212221211131444400000000000000000000000000000
00000000000000000000000000044213332211213313231122321221122112323323313233232311313313122323332311232122322331323322212400000000000000000000000000000
00000000000000000000000000004412133132313322131222231212122223121323322131233331221311231223122212133222211222332223121424400000000000000000000000000
00000000000000000000000000000444132331132221132231122132311132231131331222312211233111331321333332211131333232131223213444400000000000000000000000000
00000000000000000000000000000004422221313133231222123112131231311222321111131221112313113232312132323223231332123222133114400000000000000000000000000
00000000000000000000000000000004423312312233221331222122222111223231231332312211233233333331331233221112231213121123321144400000000000000000000000000
00000000000000000000000000000000442231112223332231311121122311131323333213112232111231322321123321313132321333223231231144440000000000000000000000000
00000000000000000000000000000000044133132312121233333131322222223312131113333222131133322112322131133113312223331123231244440000000000000000000000000
00000000000000000000000000000000004412333332222321321221111322123333231221211123211331231322222122322313231111311323212314444000000000000000000000000
00000000000000000000000000000000004131112231233222233233232211322312331122232221231112313223132131121213323131212323221434440400000000000000000000000
00000000000000000000000000000000000044222331311222113331211332331123323331212331313131123123312321333121332221112221123244444400000000000000000000000
00000000000000000000000000000000000044432212111113231223122121211332231331322213323223132333331113333232122223111131223344440400000000000000000000000
00000000000000000000000000000000000000441123332111131311212332222212223232223211323321131313113133321111111223232323132323444000000000000000000000000
00000000000000000000000000000000000000044312133233213111132221321123113232223132232332212232313321113323133333223121132244444400000000000000000000000
00000000000000000000000000000000000000004433213311112111323233322331333121211322121211213332131313223231213121232322322244444400000000000000000000000
00000000000000000000000000000000000000004441122213221222323233231321132311223311231221131223311211111211231221222333223324444400000000000000000000000
00000000000000000000000000000000000000000444211221213231233131322121211333223311232223121333132323322211232232122212231124444400000000000000000000000
00000000000000000000000000000000000000000044421112321223331311231222131312233231331113121212112133211321132213331311312144444000000000000000000000000
00000000000000000000000000000000000000000000444323323111322333131213132112123213223221311213212212332313212133213312123441300000000000000000000000000
00000000000000000000000000000000000000000000044441121232113321322311132323123231232233121213123123233332113111232222244421000000000000000000000000000
00000000000000000000000000000000000000000000004441322321121112222333313232322313213331222323133132122232113231123324444302000000000000000000000000000
00000000000000000000000000000000000000000000000444344121221113332322221121312222111132312332313323211323223322332244440000000000000000000000000000000
00000000000000000000000000000000000000000000000000444421123111111212322333323323311211112131222233322231132211144414000000000000000000000000000000000
00000000000000000000000000000000000000000000000000044444441442122333111321211321212121221113132333224444444444444400000000000000000000000000000000000
00000000000000000000000000000000000000000000000000000000444444444444444444444444444444444444444444440000000000000000000000000000000000000000000000000
00000000000000000000000000000000000000000000000000000000000000444444444444444444444444444444444000000000000000000000000000000000000000000000000000000
00000000000000000000000000000000000000000000000000000000000000000000000000000000000000000000000000000000000000000000000000000000000000000000000000000
00000000000000000000000000000000000000000000000000000000000000000000000000000000000000000000000000000000000000000000000000000000000000000000000000000
00000000000000000000000000000000000000000000000000000000000000000000000000000000000000000000000000000000000000000000000000000000000000000000000000000
00000000000000000000000000000000000000000000000000000000000000000000000000000000000000000000000000000000000000000000000000000000000000000000000000000
00000000000000000000000000000000000000000000000000000000000000000000000000000000000000000000000000000000000000000000000000000000000000000000000000000
