0102010301010301
0301010302010203
0201030202030303
0201010102030101
0203010203010301
0101030201020302
0103020301030101
0301010203030203
