0103020301020201
0302030103010202
0101020103010302
0302030102010301
0202030301030102
0302020102010201
0302030102010303
0201020302020103
