0301020101020303
0201020301030302
0102010103010201
0301030102010102
0101030303010103
0301010203010302
0102020103030103
0303030101020303
