00000000000000000000000000000000000000000000000000000000000000000000000000000000000000000000000000000000000000000000000000000000000000000000000000000
00000000000000000000000000000000000000000000000000000000000000000000000000000000000000000000000000000000000000000000000000000000000000000000000000000
00000000000000000000000000000000000000000000000000000000000000000000000000000000000000000000000000000000000000000000000000000000000000000000000000000
00000000000000000000000000000000000000000000000000000000000000000000000000000000000000000000000000000000000000000000000000000000000000000000000000000
00000000000000000000000000000000000000000000000000000000000000000000000000000000000000000000000000000000000000000000000000000000000000000000000000000
00000000000000000000000000000000000000000000000000000000000000000000000000000000000000000000000000000000000000000000000000000000000000000000000000000
00000000000000000000000000000000000000000000000000000000000000000000000000000000000000000000000000000000000000000000000000000000000000000000000000000
00000000000000000000000000000000000000000000000000000000000000000000000000000000000000000000000000000000000000000000000000000000000000000000000000000
00000000000000000000044444444444444444444444444444444444444444444444444444444444444444444444444444444444444000000000000000000000000000000000000000000
00000000000000000044444111211331122122313122331321123121332121212312131121313121111333122333223312231312221400000000000000000000000000000000000000000
00000000000000000444323233111111232322211211121222222321232212121323233321123113131321212311212213313232331440000000000000000000000000000000000000000
00000000000000000423223313213333321111122312112211212321331111311323122123132232321213233232222331111132122244000000000000000000000000000000000000000
00000000000000000423331332131331213313311332321133233211131122232112213123312321231131323322213223322222213124440000000000000000000000000000000000000
00000000000000000422331231233112132121233213313113121223113111312111312221111221122312311311313231323112132224444000000000000000000000000000000000000
00000000000000000044323212222211321331233223112232123331232332133231231133132233313112123213321132123222122313444400000000000000000000000000000000000
00000000000000000044332213221332123121232332313212331331231112233131332223212131123133131131212331213311121111244440000000000000000000000000000000000
00000000000000000000433133232113122113223322221112121232312332211321223111322211332223331333332122312213232311133140000000000000000000000000000000000
00000000000000000000021131333223212132331222113231122223213233121232311311333321332332322321312333312132112131212344000000000000000000000000000000000
00000000000000000000002223111222112212123333232312311332233331233233231111221323323122121213333312323233212121112444400000000000000000000000000000000
00000000000000000000000413321231221213132321111231231332322321312233212332123312212133231122311222231322233112113344440000000000000000000000000000000
00000000000000000000000042233223123121113313222223131212233333312311312211122233122321223121211221232332222121333144444000000000000000000000000000000
00000000000000000000000004121212113112333323332211113222112232321321122121231112321321211212233331322221333223321234444000000000000000000000000000000
00000000000000000000000000443332131323213313331133231333231231231322332213121111213123233113211332321121133333321211444400000000000000000000000000000
00000000000000000000000000042221332123112313133221231131221112331122323311212233123111122313131133331122323323312223444400000000000000000000000000000
00000000000000000000000000044311113111221321123132132231212133113112323112333333113212333112222212311223113223222313333400000000000000000000000000000
00000000000000000000000000004413323123212223212311221123312322223332211121312232332123112222233112132221212112331133133424400000000000000000000000000
00000000000000000000000000000444121223112131212322111231322232232133332321231121313223132322113112211313232332322233123444400000000000000000000000000
00000000000000000000000000000004422212211331123231232213111221312131233333312313313131112331132232211323322233231321133214400000000000000000000000000
00000000000000000000000000000004421232313212131322231221233121331222211312133313233312123113131213122123212221131231223244400000000000000000000000000
00000000000000000000000000000000441133312331213123312333132333131122232213121111223132221312123313211313121133221312112344440000000000000000000000000
00000000000000000000000000000000044221323133113233221322123232223121333211321322232111322211332231223112221132111223332344440000000000000000000000000
00000000000000000000000000000000004423231212222213222333232122231321213221332122112223213331322133332313322232313232333314444000000000000000000000000
00000000000000000000000000000000004233332131132211322112231332331112132123212312333231311222232222322111211112331131333414440400000000000000000000000
00000000000000000000000000000000000044211213222131131212332222111232323311113312312213113133111232331222332213333223111344444400000000000000000000000
00000000000000000000000000000000000044432312213131212332332113223131232212331131122313133332131231321112222132233323121344440400000000000000000000000
00000000000000000000000000000000000000443311132323312122112233323313323313112213323212111333113132131221113331122231213322444000000000000000000000000
00000000000000000000000000000000000000044123213311331233331233122312332233312121133113313231123121211122232113312313133344444400000000000000000000000
00000000000000000000000000000000000000004432212211313312332123113312211212121113132212113132313212111131121111232331322144444400000000000000000000000
00000000000000000000000000000000000000004443132212231221122322112211211232322223313233121231213332333121233313313133232234444400000000000000000000000
00000000000000000000000000000000000000000444312332322312212131131122213311321131231233212323332131113332121132121232222124444400000000000000000000000
00000000000000000000000000000000000000000044431232123322122213213313333111113213223113213221121132323223211312131123311344444000000000000000000000000
00000000000000000000000000000000000000000000444211323222313112311213131233123132332211133111111131132323323332132222333441200000000000000000000000000
00000000000000000000000000000000000000000000044441313131321131232121321322331132121121232311322112221112223113122233244431000000000000000000000000000
00000000000000000000000000000000000000000000004442331122311233332122232121111223113212332332121222231132123123332114444303000000000000000000000000000
00000000000000000000000000000000000000000000000444144311333221333231333323222122121212233233323132333133231133122144440000000000000000000000000000000
00000000000000000000000000000000000000000000000000444413232113321123321123213312211231131332131113211122333333344424000000000000000000000000000000000
00000000000000000000000000000000000000000000000000044444443443331112122312233321212132211322113223314444444444444400000000000000000000000000000000000
00000000000000000000000000000000000000000000000000000000444444444444444444444444444444444444444444440000000000000000000000000000000000000000000000000
00000000000000000000000000000000000000000000000000000000000000444444444444444444444444444444444000000000000000000000000000000000000000000000000000000
00000000000000000000000000000000000000000000000000000000000000000000000000000000000000000000000000000000000000000000000000000000000000000000000000000
00000000000000000000000000000000000000000000000000000000000000000000000000000000000000000000000000000000000000000000000000000000000000000000000000000
00000000000000000000000000000000000000000000000000000000000000000000000000000000000000000000000000000000000000000000000000000000000000000000000000000
00000000000000000000000000000000000000000000000000000000000000000000000000000000000000000000000000000000000000000000000000000000000000000000000000000
00000000000000000000000000000000000000000000000000000000000000000000000000000000000000000000000000000000000000000000000000000000000000000000000000000
