0302010302010202
0202010203030103
0101030303030102
0201030201010302
0201020101030102
0302010303010302
0102010102010202
0201030102030101
