00000000000000000000000000000000000000000000000000000000000000000000000000000000000000000000000000000000000000000000000000000000000000000000000000000
00000000000000000000000000000000000000000000000000000000000000000000000000000000000000000000000000000000000000000000000000000000000000000000000000000
00000000000000000000000000000000000000000000000000000000000000000000000000000000000000000000000000000000000000000000000000000000000000000000000000000
00000000000000000000000000000000000000000000000000000000000000000000000000000000000000000000000000000000000000000000000000000000000000000000000000000
00000000000000000000000000000000000000000000000000000000000000000000000000000000000000000000000000000000000000000000000000000000000000000000000000000
00000000000000000000000000000000000000000000000000000000000000000000000000000000000000000000000000000000000000000000000000000000000000000000000000000
00000000000000000000000000000000000000000000000000000000000000000000000000000000000000000000000000000000000000000000000000000000000000000000000000000
00000000000000000000000000000000000000000000000000000000000000000000000000000000000000000000000000000000000000000000000000000000000000000000000000000
00000000000000000000044444444444444444444444444444444444444444444444444444444444444444444444444444444444444000000000000000000000000000000000000000000
00000000000000000044444123112123132222312133123223113333233313331322221113113222313311333121312113131133112400000000000000000000000000000000000000000
00000000000000000444311212121321221332333113133131332212113111122122322122313323121132123222333332331321323440000000000000000000000000000000000000000
00000000000000000432132222111223133233333223311212233211312311313333232131133112322311323222132231311232131144000000000000000000000000000000000000000
00000000000000000422332332233111312333321231332312122221321123222211221323222311112211122323133213211223122234440000000000000000000000000000000000000
00000000000000000423211131332332113112121111321121332222322232223232223132332233322221221321222313121211312334444000000000000000000000000000000000000
00000000000000000044331211132313331213332311313222331231112213211312212322311123113312311133121312323221332131444400000000000000000000000000000000000
00000000000000000044221121232133131222332312133322123131121211323231111123211133133122313323322232222211222313144440000000000000000000000000000000000
00000000000000000000422223312323323123133333132122313133332313313113133132131122312111221333131113131322211212313340000000000000000000000000000000000
00000000000000000000012211321212212113232233311311323311321222231313112121212321113231323113133223212111211233133144000000000000000000000000000000000
00000000000000000000002112323112322211111233332231213331332331312213313112132311233321223211211223322233232211223444400000000000000000000000000000000
00000000000000000000000421231212233112121212322311311232232232312231222312132311232231233232231132322332312322112144440000000000000000000000000000000
00000000000000000000000041313233331222312332321122332211221322333123213213133213233323113132122122311132331212313244444000000000000000000000000000000
00000000000000000000000004333232121333311313113323131212313213133123131221213322333233211133311321111321121221321114444000000000000000000000000000000
00000000000000000000000000442211232222332112131212213223131232312322131332332112223331232232311223111323133113111111444400000000000000000000000000000
00000000000000000000000000042213121213222113313232331323322122311111122212232122123321222123321121322213112332213231444400000000000000000000000000000
00000000000000000000000000044323122113122221221132312131222221322311332311323321212323222113232333213121132323122322223400000000000000000000000000000
00000000000000000000000000004413331122131313123131123333132223133233122231221223313122321111232231233311333113122123221424400000000000000000000000000
00000000000000000000000000000444321322331122331113122112132221233133133111223321321211333212313312332122212322332131222444400000000000000000000000000
00000000000000000000000000000004413233111212311313321332122122232122213113112333232331223121121133232222231222213221313224400000000000000000000000000
00000000000000000000000000000004412213133332321311113223222231132132322333111112313322232331323331232223321132111222232244400000000000000000000000000
00000000000000000000000000000000442221322211232321312111331212111223323232233231323123122321231331233331121211132211223144440000000000000000000000000
00000000000000000000000000000000044333231111133333123233231122121212212112312122212213223112112122322111231222111221231344440000000000000000000000000
00000000000000000000000000000000004433111223333332232131233131321312223212223212232332313121112231123123221211132113223314444000000000000000000000000
00000000000000000000000000000000004232333323121111321333111233133233321133311111333223223331133111233323321223333123312424440400000000000000000000000
00000000000000000000000000000000000044311312223133331232223223332222212213131231333331123213113221212223121133311121333344444400000000000000000000000
00000000000000000000000000000000000044432213231323112313113223121313131222221131232231233232111322111322323331113122323244440400000000000000000000000
00000000000000000000000000000000000000441212213232323233113322213213212231321311231213222123133223212133313212323321323212444000000000000000000000000
00000000000000000000000000000000000000044212233111221121323322323122223121131222231212133133311233111312312122211113222244444400000000000000000000000
00000000000000000000000000000000000000004433212121232113312131132132312112213221122332123321112323323122323311113332333344444400000000000000000000000
00000000000000000000000000000000000000004441122233313213213333132232113131122212231333131333131111131133312322133222213314444400000000000000000000000
00000000000000000000000000000000000000000444133132111133121113123323213233131333233212222131322131221323322331321132333324444400000000000000000000000
00000000000000000000000000000000000000000044421312313113121231332332232211113112221312132323123132213123332132323323212244444000000000000000000000000
00000000000000000000000000000000000000000000444231332212313221221112132122223322233312333331121211322132122112132133333441200000000000000000000000000
00000000000000000000000000000000000000000000044443321122312122131321211231213132221213122323123232312132233133233323144421000000000000000000000000000
00000000000000000000000000000000000000000000004441223131322133111333322331323211132232212223112321221331212321133114444203000000000000000000000000000
00000000000000000000000000000000000000000000000444144112221132232313232311231211132123313211311111213312213213322144440000000000000000000000000000000
00000000000000000000000000000000000000000000000000444432322131212333332121133313321312312333213132313111322131344434000000000000000000000000000000000
00000000000000000000000000000000000000000000000000044444442441311313311233231231313311121231232332324444444444444400000000000000000000000000000000000
00000000000000000000000000000000000000000000000000000000444444444444444444444444444444444444444444440000000000000000000000000000000000000000000000000
00000000000000000000000000000000000000000000000000000000000000444444444444444444444444444444444000000000000000000000000000000000000000000000000000000
00000000000000000000000000000000000000000000000000000000000000000000000000000000000000000000000000000000000000000000000000000000000000000000000000000
00000000000000000000000000000000000000000000000000000000000000000000000000000000000000000000000000000000000000000000000000000000000000000000000000000
00000000000000000000000000000000000000000000000000000000000000000000000000000000000000000000000000000000000000000000000000000000000000000000000000000
00000000000000000000000000000000000000000000000000000000000000000000000000000000000000000000000000000000000000000000000000000000000000000000000000000
00000000000000000000000000000000000000000000000000000000000000000000000000000000000000000000000000000000000000000000000000000000000000000000000000000
