00000000000000000000000000000000000000000000000000000000000000000000000000000000000000000000000000000000000000000000000000000000000000000000000000000
00000000000000000000000000000000000000000000000000000000000000000000000000000000000000000000000000000000000000000000000000000000000000000000000000000
00000000000000000000000000000000000000000000000000000000000000000000000000000000000000000000000000000000000000000000000000000000000000000000000000000
00000000000000000000000000000000000000000000000000000000000000000000000000000000000000000000000000000000000000000000000000000000000000000000000000000
00000000000000000000000000000000000000000000000000000000000000000000000000000000000000000000000000000000000000000000000000000000000000000000000000000
00000000000000000000000000000000000000000000000000000000000000000000000000000000000000000000000000000000000000000000000000000000000000000000000000000
00000000000000000000000000000000000000000000000000000000000000000000000000000000000000000000000000000000000000000000000000000000000000000000000000000
00000000000000000000044444444444444444444444444444444444444444444444444444444444444444444444444444444440000000000000000000000000000000000000000000000
00000000000000044444444444444444444444444444444444444444444444444444444444444444444444444444444444444444444000000000000000000000000000000000000000000
00000000044444444444444133232222113222311222133311213321312222311231212311122312332312222312123112122111132400000000000000000000000000000000000000000
00000000442112233222111123312232233123132213221133132122331122121233312312112333133321132323312311232232221440000000000000000000000000000000000000000
00000000444211131221221322223223311331211121333321131313312323213221132122313223132111331223222322323323123344000000000000000000000000000000000000000
00000000044422232213321311231311333231121311111121313213323221123212313323113322233111233133131231111223123324440000000000000000000000000000000000000
00000000044332121233323111213322233123232121213123223321133111331213231133223232321322222321332322223212223124444000000000000000000000000000000000000
00000000004444333321233221133221322331231123312322212222332121123221223223131223331312221321311123121321332322444400000000000000000000000000000000000
00000000000004444212233211122122233131223312113223231213221132332112333133313221223221332211221122332133323122144440000000000000000000000000000000000
00000000000000044444421311333212122311331112331213223322321212132132133123111221323121311223221222332211212132313140000000000000000000000000000000000
00000000000000000044431232221211223222113323131331132233211121212332311112231212113232232111122332323121221321312244000000000000000000000000000000000
00000000000000000000442111121322332112233212311122312311113123233313112121133123221122221311213122121221113122213444400000000000000000000000000000000
00000000000000000000044413311223321313333133232333221113323312123112121311211113211322211132331133322323122133123244440000000000000000000000000000000
00000000000000000000004441113231221222123333132223122231123223121211123131113113313311111113321332231323232331312344444000000000000000000000000000000
00000000000000000000000044131211112233322112331312213231233113213323332223123213121212123332132113132113313121331324444000000000000000000000000000000
00000000000000000000000004441211321313332313232333121233322212333231121231331223123213233213231213132223322211112123444400000000000000000000000000000
00000000000000000000000000441111212333113121313222221232133233133123311121312112231321232133313111133212323223131231444440000000000000000000000000000
00000000000000000000000000444331311222331131331113311331212211212212312122231232232312133213222223121223331211223233121440000000000000000000000000000
00000000000000000000000000044413112132123123233331213122323212332122231231121321232322322132132122223133112233222233223444400000000000000000000000000
00000000000000000000000000004444132122133331121333211223223123123213312322232331212121232333211323112222233121232123211444400000000000000000000000000
00000000000000000000000000000044411331113133131322122322312333123123123332312323213332112133211112133332123312322132112234400000000000000000000000000
00000000000000000000000000000004422322312122333213223222322331321321232131223111311233331131313313232232311212323113212144400000000000000000000000000
00000000000000000000000000000000442331322311132111113113323211312332223111313111312112322332113123131232332333112212312144440000000000000000000000000
00000000000000000000000000000000044211212131211223122111221213132132221323333112321212113131233111222332232321312213231144440000000000000000000000000
00000000000000000000000000000000004412232112232131212323321323332132313121231313123332311222131123312323231313121122113234444000000000000000000000000
00000000000000000000000000000000004123322122332211312112233312121311211131121321313231323322223133333122231233212221222414444400000000000000000000000
00000000000000000000000000000000000044311212113112312211212231211313133131323312322231131122322113333122233133313232332244444400000000000000000000000
00000000000000000000000000000000000044413313332333111233132133212133232222133323133313121222312311333322212223112232232344444400000000000000000000000
00000000000000000000000000000000000000441312133332322313212312213313112112121212123123322121231212121312123213111333121131444440000000000000000000000
00000000000000000000000000000000000000044333212211123321331211111212222111331322221222113122221112123213132332321311233244444440000000000000000000000
00000000000000000000000000000000000000004433213223322312323231223133122221331332121121331113223221211132132211133313212344444440000000000000000000000
00000000000000000000000000000000000000004441313132231132233121213222213232111123333121123212111112232222322332112121111314444440000000000000000000000
00000000000000000000000000000000000000000444332111121211113323333332132211223313321321332312233221111111222321213122323324444440000000000000000000000
00000000000000000000000000000000000000000044433123122131333121121321133213123332231333222132211231133211123211233233131344444400000000000000000000000
00000000000000000000000000000000000000000000444223322332323133322221221223312333211312221231213233211231112232311231322444444000000000000000000000000
00000000000000000000000000000000000000000000044442223212322332213132333122212231112113112121322131331112123312132113244444440000000000000000000000000
00000000000000000000000000000000000000000000004442231313233122321113121232122321113321223132122211211312213112213314444444400000000000000000000000000
00000000000000000000000000000000000000000000000444244213211133233231311222313223131232221212232213313311221311332344444440000000000000000000000000000
00000000000000000000000000000000000000000000000000444411212133223321113221111122133331322213312321322123123332244444444000000000000000000000000000000
00000000000000000000000000000000000000000000000000044444443442333122323322112131312231222232232213134444444444444444400000000000000000000000000000000
00000000000000000000000000000000000000000000000000000000444444444444444444444444444444444444444444444440000000000000000000000000000000000000000000000
00000000000000000000000000000000000000000000000000000000000000444444444444444444444444444444444000000000000000000000000000000000000000000000000000000
00000000000000000000000000000000000000000000000000000000000000000000000000000000000000000000000000000000000000000000000000000000000000000000000000000
00000000000000000000000000000000000000000000000000000000000000000000000000000000000000000000000000000000000000000000000000000000000000000000000000000
00000000000000000000000000000000000000000000000000000000000000000000000000000000000000000000000000000000000000000000000000000000000000000000000000000
00000000000000000000000000000000000000000000000000000000000000000000000000000000000000000000000000000000000000000000000000000000000000000000000000000
00000000000000000000000000000000000000000000000000000000000000000000000000000000000000000000000000000000000000000000000000000000000000000000000000000
