00000000000000000000000000000000000000000000000000000000000000000000000000000000000000000000000000000000000000000000000000000000000000000000000000000
00000000000000000000000000000000000000000000000000000000000000000000000000000000000000000000000000000000000000000000000000000000000000000000000000000
00000000000000000000000000000000000000000000000000000000000000000000000000000000000000000000000000000000000000000000000000000000000000000000000000000
00000000000000000000000000000000000000000000000000000000000000000000000000000000000000000000000000000000000000000000000000000000000000000000000000000
00000000000000000000000000000000000000000000000000000000000000000000000000000000000000000000000000000000000000000000000000000000000000000000000000000
00000000000000000000000000000000000000000000000000000000000000000000000000000000000000000000000000000000000000000000000000000000000000000000000000000
00000000000000000000000000000000000000000000000000000000000000000000000000000000000000000000000000000000000000000000000000000000000000000000000000000
00000000000000000000000000000000000000000000000000000000000000000000000000000000000000000000000000000000000000000000000000000000000000000000000000000
00000000000000000000044444444444444444444444444444444444444444444444444444444444444444444444444444444444444000000000000000000000000000000000000000000
00000000000000000044444123221223333321321312122233133321221221113113231121313331321111221323312231321121322400000000000000000000000000000000000000000
00000000000000000444132122333131133113311131311323333332123312112222213131131331133223223323213131322133331440000000000000000000000000000000000000000
00000000000000000431122232221322113311322331233231123322132323131211313323232111232321133321333331123213312144000000000000000000000000000000000000000
00000000000000000422113133121112111113223122332121132323123333111332321332213322222132133311121232121122111114440000000000000000000000000000000000000
00000000000000000423113232121321311322331113312133123321323311222323133332312122321111222311113231233123112134444000000000000000000000000000000000000
00000000000000000044321231311122113331113131321321211121332222331231223133212211222331131323213332211321323323444400000000000000000000000000000000000
00000000000000000044132311332111112113232133123323131113221211112111333113212321312113123332112311323123133312144440000000000000000000000000000000000
00000000000000000000413312222322113222322121123313213231311133331111323333112333133131211322113311213132223223123140000000000000000000000000000000000
00000000000000000000011321133232132322211113133133123331211111311121311211312223211323313321313121132232131112232144000000000000000000000000000000000
00000000000000000000002331133222222111313213233311222233121212313233321122321322232131222131113313111123313331231444400000000000000000000000000000000
00000000000000000000000421331323231211323112323111312122131222333312111331223113121332132221311313112311132322232344440000000000000000000000000000000
00000000000000000000000042221331112211122311123233222332323333233221132333333223221312213221123211231331112233313344444000000000000000000000000000000
00000000000000000000000004133222332133332311231133312123322212321323223312212232313222113133133312122122331333212334444000000000000000000000000000000
00000000000000000000000000442323221121111222332133211333111331112212123322123311222313233321123232122223222221132133444400000000000000000000000000000
00000000000000000000000000043323221132212231221133331323133321121212311322212311131233232333131313231121112222232231444400000000000000000000000000000
00000000000000000000000000044323333212211123332121231322111122111223321331131133212231312123132313221131133121332313113400000000000000000000000000000
00000000000000000000000000004411322323221323133123132332121121321312312132321322111112332121113213232211311131332121232414400000000000000000000000000
00000000000000000000000000000444321113211313322222232321331132322222313323121132231331233121133223232311122312232233332444400000000000000000000000000
00000000000000000000000000000004423213112111213212223332232113122212221121322323131221311113132212112221233131232313222234400000000000000000000000000
00000000000000000000000000000004422313123223113132311113111322122322311312132332111331131221133122331131312213222223121344400000000000000000000000000
00000000000000000000000000000000441121312213113122233121311122112313311322133233333323221333112133133311313122223322211244440000000000000000000000000
00000000000000000000000000000000044122123133222312112312121112213212222332223331221122312123323123321223123211331221223144440000000000000000000000000
00000000000000000000000000000000004422332131131223311121123113323222132111323322212322323311111313113222132312123231313314444000000000000000000000000
00000000000000000000000000000000004223232312331132111131123133123333131232321312211312211113333233121231131323212333132414440400000000000000000000000
00000000000000000000000000000000000044211223213333312132123323131321331223111121123122113212331332313223121232121231312344444400000000000000000000000
00000000000000000000000000000000000044413113223113232332233121322122221213211232111123332313333132223233233311331221331344440400000000000000000000000
00000000000000000000000000000000000000443112222332322311112321333232313123122322232312131312111212113322233332213211313211444000000000000000000000000
00000000000000000000000000000000000000044212332132311312211323133132133123113223313331111223132111121311132132111133122144444400000000000000000000000
00000000000000000000000000000000000000004411312312333112232112121311212333212222322113121313213222322232322323212332322144444400000000000000000000000
00000000000000000000000000000000000000004443122121322111223322323233111331323221333123133321222133312221121313232132232234444400000000000000000000000
00000000000000000000000000000000000000000444121233323213321231311113331213312131121132323211112133121222231321223313332314444400000000000000000000000
00000000000000000000000000000000000000000044411221132322113312121223122321121113113221211123311113223213323323221312233344444000000000000000000000000
00000000000000000000000000000000000000000000444213212133211331223123112223222111332332312111312331233323122123212221231443300000000000000000000000000
00000000000000000000000000000000000000000000044442221231221132123231132122331311223123112212212221213311121233223321344421000000000000000000000000000
00000000000000000000000000000000000000000000004441333322311321321333122222233312112133233111213213123111323321122324444301000000000000000000000000000
00000000000000000000000000000000000000000000000444344111212212333323212121231312122322213121312122122123312332322344440000000000000000000000000000000
00000000000000000000000000000000000000000000000000444431212132223122211122111232223221212212321221222121131333144414000000000000000000000000000000000
00000000000000000000000000000000000000000000000000044444442441332132212311121222321222131232212123134444444444444400000000000000000000000000000000000
00000000000000000000000000000000000000000000000000000000444444444444444444444444444444444444444444440000000000000000000000000000000000000000000000000
00000000000000000000000000000000000000000000000000000000000000444444444444444444444444444444444000000000000000000000000000000000000000000000000000000
00000000000000000000000000000000000000000000000000000000000000000000000000000000000000000000000000000000000000000000000000000000000000000000000000000
00000000000000000000000000000000000000000000000000000000000000000000000000000000000000000000000000000000000000000000000000000000000000000000000000000
00000000000000000000000000000000000000000000000000000000000000000000000000000000000000000000000000000000000000000000000000000000000000000000000000000
00000000000000000000000000000000000000000000000000000000000000000000000000000000000000000000000000000000000000000000000000000000000000000000000000000
00000000000000000000000000000000000000000000000000000000000000000000000000000000000000000000000000000000000000000000000000000000000000000000000000000
