00000000000000000000000000000000000000000000000000000000000000000000000000000000000000000000000000000000000000000000000000000000000000000000000000000
00000000000000000000000000000000000000000000000000000000000000000000000000000000000000000000000000000000000000000000000000000000000000000000000000000
00000000000000000000000000000000000000000000000000000000000000000000000000000000000000000000000000000000000000000000000000000000000000000000000000000
00000000000000000000000000000000000000000000000000000000000000000000000000000000000000000000000000000000000000000000000000000000000000000000000000000
00000000000000000000000000000000000000000000000000000000000000000000000000000000000000000000000000000000000000000000000000000000000000000000000000000
00000000000000000000000000000000000000000000000000000000000000000000000000000000000000000000000000000000000000000000000000000000000000000000000000000
00000000000000000000000000000000000000000000000000000000000000000000000000000000000000000000000000000000000000000000000000000000000000000000000000000
00000000000000000000000000000000000000000000000000000000000000000000000000000000000000000000000000000000000000000000000000000000000000000000000000000
00000000000000000000044444444444444444444444444444444444444444444444444444444444444444444444444444444444444000000000000000000000000000000000000000000
00000000000000000044444313333233313111323323331123221123123233222223332331211232223322332112223333312111311400000000000000000000000000000000000000000
00000000000000000444231331212331211323313112123311131133222133323313321313232233323131122212312233122212233440000000000000000000000000000000000000000
00000000000000000423231331211311332122331131113122122121311321121221123133322332311132211121211222213332212344000000000000000000000000000000000000000
00000000000000000432121323231112323313332333111333232331123332112113213221123332113123233133112111121221222234440000000000000000000000000000000000000
00000000000000000431312212223312323321121111121132313212232323233233311113123331132133323332132133111331232124444000000000000000000000000000000000000
00000000000000000044331112133213312212322311211212223213123311313331212332121313111322121322231313222112131321444400000000000000000000000000000000000
00000000000000000044212111331332223323131312211331231131323213133111232112121121223222213333221332223133112122144440000000000000000000000000000000000
00000000000000000000432133323231133221111232222211132121311333331131313313331111231121131112312111121212322213213340000000000000000000000000000000000
00000000000000000000013132323233221111211123122111133321111223233331113213122131131132233212311312333331322332211344000000000000000000000000000000000
00000000000000000000001233312211322331333322121133213113123121333112312333312211331311112312221232113133211121111444400000000000000000000000000000000
00000000000000000000000433222221231331113231321133122232331133111313231322323331113123133113222323211321121223213144440000000000000000000000000000000
00000000000000000000000041331211112111123232232232122233312213332122322111213121223122133111313321112211113133213144444000000000000000000000000000000
00000000000000000000000004212211211232211122311313322232333323221121331313323313321122323213223321232222311222232134444000000000000000000000000000000
00000000000000000000000000441133333232332331212133231331233213111211232113331332313133232232112332232121311323332321444400000000000000000000000000000
00000000000000000000000000042223113211112333122233223232232232232331331212223333331321121322331123131231212211132231444400000000000000000000000000000
00000000000000000000000000044222232211113112121233333311232113133321112222212231332221212121321213321123223233132312311400000000000000000000000000000
00000000000000000000000000004413212112123333332212331121132323312221322222233222313111333133313211312133112311131221333414400000000000000000000000000
00000000000000000000000000000444331223211122223221221333211222133312131132223232232113211111133313111322113121311222232444400000000000000000000000000
00000000000000000000000000000004422132123312212122212113331233133221312222233232332332132213123111122322231232212123111314400000000000000000000000000
00000000000000000000000000000004423131331223213313121111111322213331123323231333211122223132211123332113132122323113211144400000000000000000000000000
00000000000000000000000000000000443212223313123112232121333321332122222311211221313111322313223122111123133122111211322244440000000000000000000000000
00000000000000000000000000000000044113112232121132232132113212112123111113321122232333322111322323212312112133111112313344440000000000000000000000000
00000000000000000000000000000000004431231312312322313331331221111313311311221233113213112211221331232223321231122112222334444000000000000000000000000
00000000000000000000000000000000004211323323132212213313332233231123213111132311112113131213121313133133333121213133132434440400000000000000000000000
00000000000000000000000000000000000044211332331131321213121112223123223111212332222111111233232121212133123331222232122244444400000000000000000000000
00000000000000000000000000000000000044422331211333123212113131232112331212313121113132133233132222111333313113131233212344440400000000000000000000000
00000000000000000000000000000000000000441313231133221221123232122113321311231132221231212111212131313213333332311332211212444000000000000000000000000
00000000000000000000000000000000000000044211321321111112131122212222122331233113231313211333112131323321131112323112213344444400000000000000000000000
00000000000000000000000000000000000000004411313113213112212311132323211123232113313132123333223113231222122123322112333344444400000000000000000000000
00000000000000000000000000000000000000004441133122131223222211131223122211121331131332232222233111211231232111221122222114444400000000000000000000000
00000000000000000000000000000000000000000444123312222222123111121232322212321313333233312223111211311332121122233332311334444400000000000000000000000
00000000000000000000000000000000000000000044412322233222311321313223133133131332232233331322232332121213321112223223212344444000000000000000000000000
00000000000000000000000000000000000000000000444232333211332211322113321111311122323113131311313133222133311233321211133442200000000000000000000000000
00000000000000000000000000000000000000000000044443133223323111332111123211123221331111212333221222121111323322333132244433000000000000000000000000000
00000000000000000000000000000000000000000000004442121311312313211131333311331212222223131323122232322333321113131224444303000000000000000000000000000
00000000000000000000000000000000000000000000000444144211213313311233221222221123131213313321112131211323231313221144440000000000000000000000000000000
00000000000000000000000000000000000000000000000000444422111332211222132131333231221223333222123221323332223323344434000000000000000000000000000000000
00000000000000000000000000000000000000000000000000044444442441232313211113133322323313123213233231334444444444444400000000000000000000000000000000000
00000000000000000000000000000000000000000000000000000000444444444444444444444444444444444444444444440000000000000000000000000000000000000000000000000
00000000000000000000000000000000000000000000000000000000000000444444444444444444444444444444444000000000000000000000000000000000000000000000000000000
00000000000000000000000000000000000000000000000000000000000000000000000000000000000000000000000000000000000000000000000000000000000000000000000000000
00000000000000000000000000000000000000000000000000000000000000000000000000000000000000000000000000000000000000000000000000000000000000000000000000000
00000000000000000000000000000000000000000000000000000000000000000000000000000000000000000000000000000000000000000000000000000000000000000000000000000
00000000000000000000000000000000000000000000000000000000000000000000000000000000000000000000000000000000000000000000000000000000000000000000000000000
00000000000000000000000000000000000000000000000000000000000000000000000000000000000000000000000000000000000000000000000000000000000000000000000000000
