0202030102010102
0302010202020201
0303030302020301
0202020302010103
0302010102030201
0101010102020103
0202030303010203
0101030101030103
