0302030303020203
0301020102030101
0202020201020302
0302010103010101
0301020301030201
0301010301020202
0303030101010101
0203030302010202
