00000000000000000000000000000000000000000000000000000000000000000000000000000000000000000000000000000000000000000000000000000000000000000000000000000
00000000000000000000000000000000000000000000000000000000000000000000000000000000000000000000000000000000000000000000000000000000000000000000000000000
00000000000000000000000000000000000000000000000000000000000000000000000000000000000000000000000000000000000000000000000000000000000000000000000000000
00000000000000000000000000000000000000000000000000000000000000000000000000000000000000000000000000000000000000000000000000000000000000000000000000000
00000000000000000000000000000000000000000000000000000000000000000000000000000000000000000000000000000000000000000000000000000000000000000000000000000
00000000000000000000000000000000000000000000000000000000000000000000000000000000000000000000000000000000000000000000000000000000000000000000000000000
00000000000000000000000000000000000000000000000000000000000000000000000000000000000000000000000000000000000000000000000000000000000000000000000000000
00000000000000000000000000000000000000000000000000000000000000000000000000000000000000000000000000000000000000000000000000000000000000000000000000000
00000000000000000000044444444444444444444444444444444444444444444444444444444444444444444444444444444444444000000000000000000000000000000000000000000
00000000000000000044444212133123113211221212112123133113211223121232112322222132111213121312223122132311133400000000000000000000000000000000000000000
00000000000000000444233113123322132211133112312232123212313313311231223113312212121221111112331132311222232440000000000000000000000000000000000000000
00000000000000000421223132212212131331121112123231332222222313322112322222232222313313132212222333333221223244000000000000000000000000000000000000000
00000000000000000412332222331111122113112222123113231312132123331212122312322333211121112133113322322133233124440000000000000000000000000000000000000
00000000000000000411223223333122133323322113111331322232222131213233332213213313121332231133333331333331123234444000000000000000000000000000000000000
00000000000000000044213222122331313113311322212212232313212223112232121231323332311232132232322133112113311111444400000000000000000000000000000000000
00000000000000000044232212111332233333132312232222121232121311232222113323112331112331331231121332132213222131344440000000000000000000000000000000000
00000000000000000000412131223111131121122321212231111211322333321222332231122331231212211321111121111111312323121240000000000000000000000000000000000
00000000000000000000031231333331222233221322112113133221331333121133322132121211211311223221123222332312211321233144000000000000000000000000000000000
00000000000000000000003132221323123312213213222122121113211113232211213331223223231332313322113211312333313323123444400000000000000000000000000000000
00000000000000000000000431313222121133113331222232122321313112221321212311323233122113323111323311312321333112211144440000000000000000000000000000000
00000000000000000000000041133221332313211231222322232133212111232212311312131333321321221132132112332312323132113144444000000000000000000000000000000
00000000000000000000000004222322332212331211133121311333112133221131332233311121123123222311332321223232113123223134444000000000000000000000000000000
00000000000000000000000000443131212231333321221111122311331211133333321312322223223123232121313222333321212323213331444400000000000000000000000000000
00000000000000000000000000041212332322311321232122132211121131111322131232333132233322121113233313332221313113333112444400000000000000000000000000000
00000000000000000000000000044132312131122311311332121321121222213211233133312333133213222331123133222333331313122221113400000000000000000000000000000
00000000000000000000000000004431322332312313131113332121131132131312311222333323322222132233121213222233231213112121221434400000000000000000000000000
00000000000000000000000000000444321213223321313212311312321323322112333332313232112112331132232213333111332311323233322444400000000000000000000000000
00000000000000000000000000000004413232232233332323333233112232312211313321213221312132111331312233222222122231312322131324400000000000000000000000000
00000000000000000000000000000004411131121113111132312221322123313222133231113213231321222112322121131231132332223332313144400000000000000000000000000
00000000000000000000000000000000442132133132212131113222122232333311333123133321112111111212311213133112333323132133321244440000000000000000000000000
00000000000000000000000000000000044311311133212211221333332231122232221322131213333113131332212233322221212222311332323244440000000000000000000000000
00000000000000000000000000000000004421122112213121223233133133322312331121212113113123323221213313123211311133123133331234444000000000000000000000000
00000000000000000000000000000000004332233133331113123321212221211313233331212323323321122221231312121321223111221122122424440400000000000000000000000
00000000000000000000000000000000000044132322222321132123221331331112221222212223231233311333323331211311323331233132131244444400000000000000000000000
00000000000000000000000000000000000044432322322233231233323321222212311322332221113312221211222321232131123132332321311144440400000000000000000000000
00000000000000000000000000000000000000441233133113133222232333112232322322123231132131212332233222232311213111322231111222444000000000000000000000000
00000000000000000000000000000000000000044133331333132132131321123321313133221311222223321233322321332222121332311222133144444400000000000000000000000
00000000000000000000000000000000000000004412231333311323312232223232232132321321131121233121333321123311123111213233222244444400000000000000000000000
00000000000000000000000000000000000000004441212231112133312133123121131231333322231322211112213122111122133322322233332324444400000000000000000000000
00000000000000000000000000000000000000000444323123231323311111332333312322232121111331323233121113211212223122331233321334444400000000000000000000000
00000000000000000000000000000000000000000044422222223131232322123322122113231132111221231323332322322333222122212111332244444000000000000000000000000
00000000000000000000000000000000000000000000444213332122311112312323323132211322232313321312112333311123133222212111221443200000000000000000000000000
00000000000000000000000000000000000000000000044442123333312313231113312113212121323211212322122211322323312313321312244422000000000000000000000000000
00000000000000000000000000000000000000000000004443112121223121323333321113311322322112112312113133332122322323213114444203000000000000000000000000000
00000000000000000000000000000000000000000000000444344132223122233111132123313123111231111322233211231112111331122344440000000000000000000000000000000
00000000000000000000000000000000000000000000000000444411233322121211221211231211133123121313312211133112331322344424000000000000000000000000000000000
00000000000000000000000000000000000000000000000000044444443442321231312131231221313121113331132132234444444444444400000000000000000000000000000000000
00000000000000000000000000000000000000000000000000000000444444444444444444444444444444444444444444440000000000000000000000000000000000000000000000000
00000000000000000000000000000000000000000000000000000000000000444444444444444444444444444444444000000000000000000000000000000000000000000000000000000
00000000000000000000000000000000000000000000000000000000000000000000000000000000000000000000000000000000000000000000000000000000000000000000000000000
00000000000000000000000000000000000000000000000000000000000000000000000000000000000000000000000000000000000000000000000000000000000000000000000000000
00000000000000000000000000000000000000000000000000000000000000000000000000000000000000000000000000000000000000000000000000000000000000000000000000000
00000000000000000000000000000000000000000000000000000000000000000000000000000000000000000000000000000000000000000000000000000000000000000000000000000
00000000000000000000000000000000000000000000000000000000000000000000000000000000000000000000000000000000000000000000000000000000000000000000000000000
