0202020101030101
0203010302030203
0201010302020301
0301010103030202
0202010103010203
0103020302030301
0301010302010301
0303030303020201
