00000000000000000000000000000000000000000000000000000000000000000000000000000000000000000000000000000000000000000000000000000000000000000000000000000
00000000000000000000000000000000000000000000000000000000000000000000000000000000000000000000000000000000000000000000000000000000000000000000000000000
00000000000000000000000000000000000000000000000000000000000000000000000000000000000000000000000000000000000000000000000000000000000000000000000000000
00000000000000000000000000000000000000000000000000000000000000000000000000000000000000000000000000000000000000000000000000000000000000000000000000000
00000000000000000000000000000000000000000000000000000000000000000000000000000000000000000000000000000000000000000000000000000000000000000000000000000
00000000000000000000000000000000000000000000000000000000000000000000000000000000000000000000000000000000000000000000000000000000000000000000000000000
00000000000000000000000000000000000000000000000000000000000000000000000000000000000000000000000000000000000000000000000000000000000000000000000000000
00000000000000000000044444444444444444444444444444444444444444444444444444444444444444444444444444444440000000000000000000000000000000000000000000000
00000000000000044444444444444444444444444444444444444444444444444444444444444444444444444444444444444444444000000000000000000000000000000000000000000
00000000044444444444444213113121123333313121132113111233221223213232311322331213312332332221221131231221221400000000000000000000000000000000000000000
00000000441333223111323221121212321323123223332331221122112133221123331122113323331232321311312232133312212440000000000000000000000000000000000000000
00000000444222331321322322331332233231132332131121133221212111223121133131331221113312223223312213111332331244000000000000000000000000000000000000000
00000000044413321321313312212111321321132111133332111211332212333333212132213321333233313132313231333232133114440000000000000000000000000000000000000
00000000044333231333332313111123333313111212113332122322122331321311321312331312213123322322131333233112321234444000000000000000000000000000000000000
00000000004444121213323123131111232322121111113323223331132123112132323323223133331233132332312213112132123221444400000000000000000000000000000000000
00000000000004444111131123231321332311311333321331221222323222112332232321231222123232213232312332111133312311344440000000000000000000000000000000000
00000000000000044444432232333121222322232312133323231223212333321311332322313333211231212123323332312311122221111340000000000000000000000000000000000
00000000000000000044423212231133132313122233311313122232231222113222221231221222122312322223122221233221223221221344000000000000000000000000000000000
00000000000000000000441321311133321333133123123213222133132122232331211212233311312231221133223232211231332212212444400000000000000000000000000000000
00000000000000000000044411211211223233233312322111331131323212232333133211222232223331132123323211311132232221211344440000000000000000000000000000000
00000000000000000000004441221222133321211323233232221321123113322132333322123323213113133232122323131213212122312144444000000000000000000000000000000
00000000000000000000000044221311332213211123311321211223323332213122222132221321211231111122133113313121212312111234444000000000000000000000000000000
00000000000000000000000004442133312131212322333232313212133113333313113111312321323311131312323323121233233233232133444400000000000000000000000000000
00000000000000000000000000443221331231132121211123321312331233133122131211222223111323133312211313211311131111123232444440000000000000000000000000000
00000000000000000000000000444112131332212131122312332131223133332221312132213222331233213232333322111332111211313112123440000000000000000000000000000
00000000000000000000000000044432132122133321222323122123321132212323311213132223131331121231111213231212121323332132113444400000000000000000000000000
00000000000000000000000000004444232131333232112231313221322213231212212211321111131233321121211323331222113231113131112444400000000000000000000000000
00000000000000000000000000000044411212311332322313223331322133313323322133312322312212232331121223332313111212113221232314400000000000000000000000000
00000000000000000000000000000004423332133321122332231332113113132221131323232223232312313121122132232322312331113332231344400000000000000000000000000
00000000000000000000000000000000444111123323313212222213112221311232121221323232323321131121231312311311213313213113332244440000000000000000000000000
00000000000000000000000000000044444441231313311333132233212212111322333121113112121122322322231212313133123222131311331244440000000000000000000000000
00000000000000000000000000000444444444311313133122113222222232113112131313111331222323312121133133221321131221222211221134444000000000000000000000000
00000000000000000000000000004444444444311132313311222133232313222221111112213121211222232212231112132212112322131321331434444400000000000000000000000
00000000000000000000000000000044444444422232112221123211212121121311313222231312133111213123222312133233112233132123331244444400000000000000000000000
00000000000000000000000000000000044444443322113322112212131321311313221113212121231312311211333222221113221312222232313244444400000000000000000000000
00000000000000000000000000000000000044442222312212322321121121232332231313322132113213222313233322221122133312113221121333444440000000000000000000000
00000000000000000000000000000000000000044332222333133321323121132233131332331322332122213212223132212123113312233131212244444440000000000000000000000
00000000000000000000000000000000000000004411232311111312123112222232211223122331232133333123332132321313112223133122112144444440000000000000000000000
00000000000000000000000000000000000000004442333322123322213321311123133121321212323121221321232232323113132331212233222134444440000000000000000000000
00000000000000000000000000000000000000000444213122121313131121313123211312312311233231122333332132113222221223231313213234444440000000000000000000000
00000000000000000000000000000000000000000044423113223333323122123311322313332131313323332233233223111112111122111312123244444400000000000000000000000
00000000000000000000000000000000000000000000444223232313333131212332133333312131333223123123123112213323211132113223222444444000000000000000000000000
00000000000000000000000000000000000000000000044443113221211221221311321313221133111332211111332122221122333233123212244444440000000000000000000000000
00000000000000000000000000000000000000000000004443212112111331213221113112223132313331221132313223112123213222332324444444400000000000000000000000000
00000000000000000000000000000000000000000000000444244211312221213121331233312111332331113311311213333212311121132144444440000000000000000000000000000
00000000000000000000000000000000000000000000000000444413122331323313221232223122332331121121333323121323123122144444444000000000000000000000000000000
00000000000000000000000000000000000000000000000000044444443443221233322233123122213133222223223131114444444444444444400000000000000000000000000000000
00000000000000000000000000000000000000000000000000000000444444444444444444444444444444444444444444444440000000000000000000000000000000000000000000000
00000000000000000000000000000000000000000000000000000000000000444444444444444444444444444444444000000000000000000000000000000000000000000000000000000
00000000000000000000000000000000000000000000000000000000000000000000000000000000000000000000000000000000000000000000000000000000000000000000000000000
00000000000000000000000000000000000000000000000000000000000000000000000000000000000000000000000000000000000000000000000000000000000000000000000000000
00000000000000000000000000000000000000000000000000000000000000000000000000000000000000000000000000000000000000000000000000000000000000000000000000000
00000000000000000000000000000000000000000000000000000000000000000000000000000000000000000000000000000000000000000000000000000000000000000000000000000
00000000000000000000000000000000000000000000000000000000000000000000000000000000000000000000000000000000000000000000000000000000000000000000000000000
