0103020101010303
0103030203010201
0201030201020201
0202020203020102
0302030201030202
0303010202020302
0302020303030301
0201020101030201
