00000000000000000000000000000000000000000000000000000000000000000000000000000000000000000000000000000000000000000000000000000000000000000000000000000
00000000000000000000000000000000000000000000000000000000000000000000000000000000000000000000000000000000000000000000000000000000000000000000000000000
00000000000000000000000000000000000000000000000000000000000000000000000000000000000000000000000000000000000000000000000000000000000000000000000000000
00000000000000000000000000000000000000000000000000000000000000000000000000000000000000000000000000000000000000000000000000000000000000000000000000000
00000000000000000000000000000000000000000000000000000000000000000000000000000000000000000000000000000000000000000000000000000000000000000000000000000
00000000000000000000000000000000000000000000000000000000000000000000000000000000000000000000000000000000000000000000000000000000000000000000000000000
00000000000000000000000000000000000000000000000000000000000000000000000000000000000000000000000000000000000000000000000000000000000000000000000000000
00000000000000000000000000000000000000000000000000000000000000000000000000000000000000000000000000000000000000000000000000000000000000000000000000000
00000000000000000000044444444444444444444444444444444444444444444444444444444444444444444444444444444444444000000000000000000000000000000000000000000
00000000000000000044444321331233113132122313311222131331311123122233331233322223121123212332213331131333213400000000000000000000000000000000000000000
00000000000000000444121222322231112321332333211233312333332213311323133123321121122212131311132221231123222440000000000000000000000000000000000000000
00000000000000000433111123121212213333113333111132212332333312133221231313133333331332233323331213313223232344000000000000000000000000000000000000000
00000000000000000412222313222221111323113311131122123122212332221233132313331233313133123232233131223233212224440000000000000000000000000000000000000
00000000000000000432322322121131232333123233332111332212121232311112313333111133223233322323112212122222122224444000000000000000000000000000000000000
00000000000000000044323132111333313111323123321131332131221221131322212331132232312313232121331312133111121232444400000000000000000000000000000000000
00000000000000000044113333213133333131222112221131213312221121112322311132231311322133231223213121233331312222144440000000000000000000000000000000000
00000000000000000000411221123121331113311312332323221313233133111331111312213123222212322331233223131321231223213240000000000000000000000000000000000
00000000000000000000022233211122112213311311231321111233122132221213131222223232131222223223212131133313131111321244000000000000000000000000000000000
00000000000000000000001223211211113123332121312133132111313233312121112212332213322221223112133222211333133123211444400000000000000000000000000000000
00000000000000000000000423331131322321123122112121111221321221323133212131131312322313213211222132123131222222222244440000000000000000000000000000000
00000000000000000000000042322231112233111113131321313113223113232212322113121122122131113121313113112333313222222344444000000000000000000000000000000
00000000000000000000000004121322122132313132132333132122111123232122323232232211121222131331211111231233232312121134444000000000000000000000000000000
00000000000000000000000000443221111312222133233323221222111312323213113133331223121222123122121213213331312312221323444400000000000000000000000000000
00000000000000000000000000041312212211323311333133221221111223111321121331323113123321323321323322312133212232112133444400000000000000000000000000000
00000000000000000000000000044211211231232323112332333311122221222333121331332323321332131231321112313112231121211133222400000000000000000000000000000
00000000000000000000000000004431132133331232211122313113122111312231313132233321233321213233321113111313121221133133332414400000000000000000000000000
00000000000000000000000000000444331112323312212121132233333112132122123332232233212322312133213232211212323321113212231444400000000000000000000000000
00000000000000000000000000000004432133122123123123232321311213231133231323132113211323213211113132233333131123312113313234400000000000000000000000000
00000000000000000000000000000004412331311232332323111233112232133321131213321213133331232331333331333132111332232231231244400000000000000000000000000
00000000000000000000000000000000442333312121322312231121321223211112123233121112312113221223113132322211222232231312312344440000000000000000000000000
00000000000000000000000000000000044132233113111222322321112331132122132211132132113113131323233331311312113333132111323144440000000000000000000000000
00000000000000000000000000000000004431233122313132223332111222233323133312231233311233211122332113133311122322112133131214444000000000000000000000000
00000000000000000000000000000000004233331221322132311222332213212223132331132323132131233132333112313123122222213322132414440400000000000000000000000
00000000000000000000000000000000000044321312231212223121122321311322122313331123321112122113123212322313133311323221221244444400000000000000000000000
00000000000000000000000000000000000044423131123123113113332321332322231123313233233113333131211113313112223313233131222244440400000000000000000000000
00000000000000000000000000000000000000441212232133221322213113331313211233212213112212311112113111311121231122312331323131444000000000000000000000000
00000000000000000000000000000000000000044313233221312333213113232311211113221112333313213331131332221211112332133321212344444400000000000000000000000
00000000000000000000000000000000000000004423132233323131311231331111211133121111313322123111132123321121311112132231111244444400000000000000000000000
00000000000000000000000000000000000000004442221131133112111331131213313211122313113331121231213221312222133122233122221224444400000000000000000000000
00000000000000000000000000000000000000000444213331113312313131122231131231211211121111222311313121323212133311211112112334444400000000000000000000000
00000000000000000000000000000000000000000044433332211211332123211131221211323311322332111332232321223132323213312331321144444000000000000000000000000
00000000000000000000000000000000000000000000444131233123212211311113213333313223222321232312122123322211233323112232331443100000000000000000000000000
00000000000000000000000000000000000000000000044441112211312233122223132113232113131123321123322221322121232232332231144423000000000000000000000000000
00000000000000000000000000000000000000000000004442122132331123131313222313132212221113221311313212332112213121311124444202000000000000000000000000000
00000000000000000000000000000000000000000000000444244223132232113333133231311211332233331211111312212131313331123344440000000000000000000000000000000
00000000000000000000000000000000000000000000000000444423332321321323233212132213231232211221311322212131121122344434000000000000000000000000000000000
00000000000000000000000000000000000000000000000000044444443441222311213131313121232213132221131313124444444444444400000000000000000000000000000000000
00000000000000000000000000000000000000000000000000000000444444444444444444444444444444444444444444440000000000000000000000000000000000000000000000000
00000000000000000000000000000000000000000000000000000000000000444444444444444444444444444444444000000000000000000000000000000000000000000000000000000
00000000000000000000000000000000000000000000000000000000000000000000000000000000000000000000000000000000000000000000000000000000000000000000000000000
00000000000000000000000000000000000000000000000000000000000000000000000000000000000000000000000000000000000000000000000000000000000000000000000000000
00000000000000000000000000000000000000000000000000000000000000000000000000000000000000000000000000000000000000000000000000000000000000000000000000000
00000000000000000000000000000000000000000000000000000000000000000000000000000000000000000000000000000000000000000000000000000000000000000000000000000
00000000000000000000000000000000000000000000000000000000000000000000000000000000000000000000000000000000000000000000000000000000000000000000000000000
