0103010301010101
0102030101030102
0301020301010103
0103020102020303
0101010303020201
0101030201020301
0302020202020201
0202030302020303
