00000000000000000000000000000000000000000000000000000000000000000000000000000000000000000000000000000000000000000000000000000000000000000000000000000
00000000000000000000000000000000000000000000000000000000000000000000000000000000000000000000000000000000000000000000000000000000000000000000000000000
00000000000000000000000000000000000000000000000000000000000000000000000000000000000000000000000000000000000000000000000000000000000000000000000000000
00000000000000000000000000000000000000000000000000000000000000000000000000000000000000000000000000000000000000000000000000000000000000000000000000000
00000000000000000000000000000000000000000000000000000000000000000000000000000000000000000000000000000000000000000000000000000000000000000000000000000
00000000000000000000000000000000000000000000000000000000000000000000000000000000000000000000000000000000000000000000000000000000000000000000000000000
00000000000000000000000000000000000000000000000000000000000000000000000000000000000000000000000000000000000000000000000000000000000000000000000000000
00000000000000000000000000000000000000000000000000000000000000000000000000000000000000000000000000000000000000000000000000000000000000000000000000000
00000000000000000000044444444444444444444444444444444444444444444444444444444444444444444444444444444444444000000000000000000000000000000000000000000
00000000000000000044444112333311233333312313112233331221131323133313213221333122113332321331132111132121111400000000000000000000000000000000000000000
00000000000000000444331332223133221123231221212323221112223313222122231221321322233223121113232221321132132440000000000000000000000000000000000000000
00000000000000000411331311123312333131133222312313232333221131222212233212312212211331123131333133111221131344000000000000000000000000000000000000000
00000000000000000421221231212213332233121221132321133113131323123111223323121132112321132121232223322111312214440000000000000000000000000000000000000
00000000000000000433122211313331111121333323132121333122113131232233313223112313113233321233311111113121313334444000000000000000000000000000000000000
00000000000000000044232311113123131131133132323222111113111312113331212113321132321331212333322222223132233131444400000000000000000000000000000000000
00000000000000000044112233331113321212311322111121121222133112122213321113121312231122311231112123323321113312244440000000000000000000000000000000000
00000000000000000000411122321331222321223113333213113222312211312213223333213111112211211133123332333211231222112240000000000000000000000000000000000
00000000000000000000032231132232322121113232323131123131133231313123131232111133213232321113321131233311213323223344000000000000000000000000000000000
00000000000000000000002222311321331312132312122113213133311313313323323321322312132223323131212313311312323232223444400000000000000000000000000000000
00000000000000000000000421313122211122133322213313313231322333112232333212322131322213222112221231232123313332111244440000000000000000000000000000000
00000000000000000000000042121113112212231122321212233333232111131222223233232123333221323322222223231121322221112344444000000000000000000000000000000
00000000000000000000000004233131333221231213132123132321123222222212331322223121332113233311313331312112233111132114444000000000000000000000000000000
00000000000000000000000000443213233323313313221113312213333121212312311321321133321333211322112233233331222323333123444400000000000000000000000000000
00000000000000000000000000041111222132113323212223112133222321122133312223313221312231122122313123332222113111233322444400000000000000000000000000000
00000000000000000000000000044121231331323211231332333333331222223321313133112332311322131232113313232123313222131131332400000000000000000000000000000
00000000000000000000000000004432332131311122211221223233312122112213223221313212112122321312131232113331212122233133232434400000000000000000000000000
00000000000000000000000000000444221231112313221331333212313213213132132331211321131121232111232113223331211313331132211444400000000000000000000000000
00000000000000000000000000000004411333333321313232233312111132131121123333213311322223113222231323211222212111212211222124400000000000000000000000000
00000000000000000000000000000004413322221321313312232133113113131311113312123121312113211212313112233231222323111123123244400000000000000000000000000
00000000000000000000000000000000441121133231122112332312311322212312131211213213122333221331233221331122213233231213233144440000000000000000000000000
00000000000000000000000000000000044121133333122111222211323231222223313222221321222212132322311111212321222223112223111144440000000000000000000000000
00000000000000000000000000000000004411122111333121322221321322212111213312133222112322333132231312223312323121123121222314444000000000000000000000000
00000000000000000000000000000000004232213323331213323232323121212332331132213323321121213131112131211121232122112112331414440400000000000000000000000
00000000000000000000000000000000000044231322121231113122121133213131312333131331321123221213123223231213323132222311233244444400000000000000000000000
00000000000000000000000000000000000044421313113212123313313321312333321133223213122223211211313223322312312212231323123344440400000000000000000000000
00000000000000000000000000000000000000442122331313323213233133133131333332333321331221212311213112122332322322312213213122444000000000000000000000000
00000000000000000000000000000000000000044122211213111211212231332123133131332332312131213312133311212131113111211223322244444400000000000000000000000
00000000000000000000000000000000000000004432313321323222221232121212132212211123111313222122112111323112122323111112322344444400000000000000000000000
00000000000000000000000000000000000000004443112321111333221211131112312112212133312121321111332122323221312131213212311114444400000000000000000000000
00000000000000000000000000000000000000000444213233121121221132212213323123123111132331322311323133113132212231222133323324444400000000000000000000000
00000000000000000000000000000000000000000044412322333111111313112112232232213122321231321131213322213133211211222122323344444000000000000000000000000
00000000000000000000000000000000000000000000444133231211122221322323122132232232322132213123321132333312123312222313233442300000000000000000000000000
00000000000000000000000000000000000000000000044441213332122221123112232123123321333113331211233213331133313222111332344411000000000000000000000000000
00000000000000000000000000000000000000000000004443131321313331213113111222313111121122231212222221332111332133333234444103000000000000000000000000000
00000000000000000000000000000000000000000000000444144323113121131122332122221211132321322123231221122222333112213244440000000000000000000000000000000
00000000000000000000000000000000000000000000000000444433332232213131133212122311223321323213122121132211333223144414000000000000000000000000000000000
00000000000000000000000000000000000000000000000000044444442441312323312132213311333212122233332132314444444444444400000000000000000000000000000000000
00000000000000000000000000000000000000000000000000000000444444444444444444444444444444444444444444440000000000000000000000000000000000000000000000000
00000000000000000000000000000000000000000000000000000000000000444444444444444444444444444444444000000000000000000000000000000000000000000000000000000
00000000000000000000000000000000000000000000000000000000000000000000000000000000000000000000000000000000000000000000000000000000000000000000000000000
00000000000000000000000000000000000000000000000000000000000000000000000000000000000000000000000000000000000000000000000000000000000000000000000000000
00000000000000000000000000000000000000000000000000000000000000000000000000000000000000000000000000000000000000000000000000000000000000000000000000000
00000000000000000000000000000000000000000000000000000000000000000000000000000000000000000000000000000000000000000000000000000000000000000000000000000
00000000000000000000000000000000000000000000000000000000000000000000000000000000000000000000000000000000000000000000000000000000000000000000000000000
