00000000000000000000000000000000000000000000000000000000000000000000000000000000000000000000000000000000000000000000000000000000000000000000000000000
00000000000000000000000000000000000000000000000000000000000000000000000000000000000000000000000000000000000000000000000000000000000000000000000000000
00000000000000000000000000000000000000000000000000000000000000000000000000000000000000000000000000000000000000000000000000000000000000000000000000000
00000000000000000000000000000000000000000000000000000000000000000000000000000000000000000000000000000000000000000000000000000000000000000000000000000
00000000000000000000000000000000000000000000000000000000000000000000000000000000000000000000000000000000000000000000000000000000000000000000000000000
00000000000000000000000000000000000000000000000000000000000000000000000000000000000000000000000000000000000000000000000000000000000000000000000000000
00000000000000000000000000000000000000000000000000000000000000000000000000000000000000000000000000000000000000000000000000000000000000000000000000000
00000000000000000000000000000000000000000000000000000000000000000000000000000000000000000000000000000000000000000000000000000000000000000000000000000
00000000000000000000044444444444444444444444444444444444444444444444444444444444444444444444444444444444444000000000000000000000000000000000000000000
00000000000000000044444133311133311233212133113222313113111123133233113111133212331222133133321221113123122400000000000000000000000000000000000000000
00000000000000000444233313222313223312213122322231231211333313113131313111211332132232131133132123221223122440000000000000000000000000000000000000000
00000000000000000413133122312211112111231312323311121312311121212322122112321212133223133213311131212233111244000000000000000000000000000000000000000
00000000000000000433323321131121211121222211211113313332312312131313113133222112113213311322332122212123321214440000000000000000000000000000000000000
00000000000000000433122331311313312233113331321231133131312311232221232211212212112112131321223111321111333134444000000000000000000000000000000000000
00000000000000000044133213113233131211131312123122311212132113231232213212122122121321232223113123111131133221444400000000000000000000000000000000000
00000000000000000044332131221333223231232213212331122123223212111312321233323313331211322213233223211331112131344440000000000000000000000000000000000
00000000000000000000431133232133213313332122112321213321313132133331222332223133313121112212233231323122331221223340000000000000000000000000000000000
00000000000000000000032223132212331332221222113121331313221221223211121133113211333312232313221312212211122322312344000000000000000000000000000000000
00000000000000000000002112212112131311321231322321231323112133233223222123331132311211122232233311232322213121322444400000000000000000000000000000000
00000000000000000000000431331112233133112211211221322233333221211221212212332121322321131232321321232213111233221144440000000000000000000000000000000
00000000000000000000000042313231213122231233213131211323223332311113112311121321331111123122221113221212322233232244444000000000000000000000000000000
00000000000000000000000004323223231123113223111122231212223321212313112132122212212333313112112231212312331223133134444000000000000000000000000000000
00000000000000000000000000441331321322331123323113233133113212132313131233222112333333312233111323122331312133212113444400000000000000000000000000000
00000000000000000000000000042233132321131133231233211213211232312212211223113312311311113233223311322232213121133123444400000000000000000000000000000
00000000000000000000000000044331111311312332312231113223233222331233233332312332121313122112313223123331121333221313221400000000000000000000000000000
00000000000000000000000000004423223332211312132313213112223223121121213231221211221323322131311133133332132332131332332434400000000000000000000000000
00000000000000000000000000000444111332211233311122133133311111311221121232213321232213231233233113222112133223222333121444400000000000000000000000000
00000000000000000000000000000004413321222331132222322213113323213132322323122121331132113123323213321322232323131312322114400000000000000000000000000
00000000000000000000000000000004423211322131223113331122333221131222133323212123221322123322232331322223311322323111122244400000000000000000000000000
00000000000000000000000000000000442112323313332132211333333212313132221332133312231333231123311122112113322111111232212244440000000000000000000000000
00000000000000000000000000000000044233231311322323111322321313312312212312321112322312213121332323113111312131211221132344440000000000000000000000000
00000000000000000000000000000000004423321321211313311311123312113132323232221321331311221111322121233311112233123213133114444000000000000000000000000
00000000000000000000000000000000004121322112331222122331232322232221123321311122233212311332212223333223313123221322231414440400000000000000000000000
00000000000000000000000000000000000044123321311232132222232322133222121211223233323113212333332322111113122121323223113244444400000000000000000000000
00000000000000000000000000000000000044412221333231323331221332332121122111212211123212123312333322232211212323222213322344440400000000000000000000000
00000000000000000000000000000000000000443213221121232111113122222321213232223133222231113223231222322233323121213211132231444000000000000000000000000
00000000000000000000000000000000000000044121333321131313311321111223131313222333333323221122113231132231132311112213312244444400000000000000000000000
00000000000000000000000000000000000000004412222133131331332332122321212212213323331231211112311121321122312313232212212244444400000000000000000000000
00000000000000000000000000000000000000004442111212332323313221223121321213312111333213233133333111233111331112323323323234444400000000000000000000000
00000000000000000000000000000000000000000444221232233332311131222112223211211322311111323212331332212132111131233231221234444400000000000000000000000
00000000000000000000000000000000000000000044423212222112223121323322313111133233331333332132313223333333123132231113122244444000000000000000000000000
00000000000000000000000000000000000000000000444332112311331212322331213332123112111322132332222132323331313113122123221441100000000000000000000000000
00000000000000000000000000000000000000000000044442133321232223131213112223113311132233132313333221213223232122331321144423000000000000000000000000000
00000000000000000000000000000000000000000000004441123321311123212322222123221233313331323132232321333231231212112314444103000000000000000000000000000
00000000000000000000000000000000000000000000000444244111313312121311212322131322133132132133333232222311121122121344440000000000000000000000000000000
00000000000000000000000000000000000000000000000000444433233212112212223232332233131322313331122321123331232133244424000000000000000000000000000000000
00000000000000000000000000000000000000000000000000044444441442331133331333323213121212222211112231314444444444444400000000000000000000000000000000000
00000000000000000000000000000000000000000000000000000000444444444444444444444444444444444444444444440000000000000000000000000000000000000000000000000
00000000000000000000000000000000000000000000000000000000000000444444444444444444444444444444444000000000000000000000000000000000000000000000000000000
00000000000000000000000000000000000000000000000000000000000000000000000000000000000000000000000000000000000000000000000000000000000000000000000000000
00000000000000000000000000000000000000000000000000000000000000000000000000000000000000000000000000000000000000000000000000000000000000000000000000000
00000000000000000000000000000000000000000000000000000000000000000000000000000000000000000000000000000000000000000000000000000000000000000000000000000
00000000000000000000000000000000000000000000000000000000000000000000000000000000000000000000000000000000000000000000000000000000000000000000000000000
00000000000000000000000000000000000000000000000000000000000000000000000000000000000000000000000000000000000000000000000000000000000000000000000000000
