00000000000000000000000000000000000000000000000000000000000000000000000000000000000000000000000000000000000000000000000000000000000000000000000000000
00000000000000000000000000000000000000000000000000000000000000000000000000000000000000000000000000000000000000000000000000000000000000000000000000000
00000000000000000000000000000000000000000000000000000000000000000000000000000000000000000000000000000000000000000000000000000000000000000000000000000
00000000000000000000000000000000000000000000000000000000000000000000000000000000000000000000000000000000000000000000000000000000000000000000000000000
00000000000000000000000000000000000000000000000000000000000000000000000000000000000000000000000000000000000000000000000000000000000000000000000000000
00000000000000000000000000000000000000000000000000000000000000000000000000000000000000000000000000000000000000000000000000000000000000000000000000000
00000000000000000000000000000000000000000000000000000000000000000000000000000000000000000000000000000000000000000000000000000000000000000000000000000
00000000000000000000000000000000000000000000000000000000000000000000000000000000000000000000000000000000000000000000000000000000000000000000000000000
00000000000000000000044444444444444444444444444444444444444444444444444444444444444444444444444444444444444000000000000000000000000000000000000000000
00000000000000000044444123313331222233213333133231122111211212322232223112112113122133112311222313132212133400000000000000000000000000000000000000000
00000000000000000444113313232322333313233223133323122231211111233321132233323213121132123222122233221313313440000000000000000000000000000000000000000
00000000000000000431222113312212322233313321123233222122321322213132111231222331312121133132231232131223321244000000000000000000000000000000000000000
00000000000000000423121223331333123332123323212232322113223132332113221232222212213113232313231112222121332334440000000000000000000000000000000000000
00000000000000000421331132121122232332332122132122211113122311332313123111133133121111313232311121211313132334444000000000000000000000000000000000000
00000000000000000044123121223131211112232123211323132332331233211122211222312111323212132221211213111313331211444400000000000000000000000000000000000
00000000000000000044112322212121123333313313121222221323132132333112311221232132112323122221112322233231213231344440000000000000000000000000000000000
00000000000000000000431211112121222121213111122211221131323232223233333122213313211233232333333323231213121111233340000000000000000000000000000000000
00000000000000000000023213232212222331112221212332233333233232122112212323313322223313221312131331231122331331322144000000000000000000000000000000000
00000000000000000000002133121132111312311112112321233131131221331123221213113121213222331222113333221312233123132444400000000000000000000000000000000
00000000000000000000000432211233223333123311331312311213131133221323333112221213322332331312332131311222211223311144440000000000000000000000000000000
00000000000000000000000043111133132231132321231333232333222223322211213331133323222133222123211332123331112313232144444000000000000000000000000000000
00000000000000000000000004212123121333111222333132313331231323312121213123213123222222132233311132232132322223313234444000000000000000000000000000000
00000000000000000000000000443212232233331321122111232221213133333122231332222323323312123123223331311332313213332133444400000000000000000000000000000
00000000000000000000000000041112321221111322212132113333312311121123113111212332122113111111112311311313133321111212444400000000000000000000000000000
00000000000000000000000000044123323212222133211332131332213213121222123331321331123331131313223312321322213233122222322400000000000000000000000000000
00000000000000000000000000004422213332321313331212212111333321323232132222313221323123221233321313132122133313132122333424400000000000000000000000000
00000000000000000000000000000444312122321113323213133211113113123333333211312231331333123211133333133121111322331221131444400000000000000000000000000
00000000000000000000000000000004432133111222123111221123221121121213231312222212211213121213221333312333132212211312332114400000000000000000000000000
00000000000000000000000000000004423211133213132131331213132332322331222133121233213321221221223123223332231123112322333144400000000000000000000000000
00000000000000000000000000000000441133213332323111332312221213323121331133321113123311212121312122232121132231323322231344440000000000000000000000000
00000000000000000000000000000000044322332221331113311221131212111211212223311132211122122313131112321322331223322321231144440000000000000000000000000
00000000000000000000000000000000004411123221221213113313123322222213332333321321111233233131211313111211211322112132133334444000000000000000000000000
00000000000000000000000000000000004312123222313313232211332322333211232123333231111321121232131111113331312112113212133414440400000000000000000000000
00000000000000000000000000000000000044323232123322332231122121311211311221232123131212222123111113323223131123121322231144444400000000000000000000000
00000000000000000000000000000000000044413332321133222113322231323323211213223233221322232333311233121121231112212313223144440400000000000000000000000
00000000000000000000000000000000000000441133312133112213222131232331131132323212311112113131131233233133231221332311312223444000000000000000000000000
00000000000000000000000000000000000000044212311313321312122221233213122311131122313322311111121333312122113223121121211244444400000000000000000000000
00000000000000000000000000000000000000004411213212331213121131211333123211213131122113231313332221122221222131232321232344444400000000000000000000000
00000000000000000000000000000000000000004443111133223122122332132231322233222332232221313121111212212212321231211131233124444400000000000000000000000
00000000000000000000000000000000000000000444322231332213213231123133133223312112221112221213231323122122231323333332331114444400000000000000000000000
00000000000000000000000000000000000000000044411331313332232223311133131132332133231121323212112112131332311222112132231244444000000000000000000000000
00000000000000000000000000000000000000000000444312111223333312121313322211322323323123222333323313232121313123223123131443100000000000000000000000000
00000000000000000000000000000000000000000000044443313223222321311221231323321233213211113233221131213322132333311233244423000000000000000000000000000
00000000000000000000000000000000000000000000004443122212222221132231212133332131312232221331132112323223121322312224444302000000000000000000000000000
00000000000000000000000000000000000000000000000444244222311233223332233112331233331221113322322123122333323332231244440000000000000000000000000000000
00000000000000000000000000000000000000000000000000444421111322311212333113123232233231122333331331233121232313344424000000000000000000000000000000000
00000000000000000000000000000000000000000000000000044444443442233131111331111112333221121211221222124444444444444400000000000000000000000000000000000
00000000000000000000000000000000000000000000000000000000444444444444444444444444444444444444444444440000000000000000000000000000000000000000000000000
00000000000000000000000000000000000000000000000000000000000000444444444444444444444444444444444000000000000000000000000000000000000000000000000000000
00000000000000000000000000000000000000000000000000000000000000000000000000000000000000000000000000000000000000000000000000000000000000000000000000000
00000000000000000000000000000000000000000000000000000000000000000000000000000000000000000000000000000000000000000000000000000000000000000000000000000
00000000000000000000000000000000000000000000000000000000000000000000000000000000000000000000000000000000000000000000000000000000000000000000000000000
00000000000000000000000000000000000000000000000000000000000000000000000000000000000000000000000000000000000000000000000000000000000000000000000000000
00000000000000000000000000000000000000000000000000000000000000000000000000000000000000000000000000000000000000000000000000000000000000000000000000000
