0103020203010203
0303020102030302
0302030101030302
0301020203030101
0203030102010203
0301020101020103
0202030103010102
0203020303020302
