   00000000000000000000000000000000000000000000000000000000000000000000000000000000000000000000000000000000000000000000000000000000000000000000000000000
   00000000000000000000000000000000000000000000000000000000000000000000000000000000000000000000000000000000000000000000000000000000000000000000000000000
   00000000000000000000000000000000000000000000000000000000000000000000000000000000000000000000000000000000000000000000000000000000000000000000000000000
   00000000000000000000000000000000000000000000000000000000000000000000000000000000000000000000000000000000000000000000000000000000000000000000000000000
   00000000000000000000000000000000000000000000000000000000000000000000000000000000000000000000000000000000000000000000000000000000000000000000000000000
   00000000000000000000000000000000000000000000000000000000000000000000000000000000000000000000000000000000000000000000000000000000000000000000000000000
   00000000000000000000000000000000000000000000000000000000000000000000000000000000000000000000000000000000000000000000000000000000000000000000000000000
   00000000000000000000044444444444444444444444444444444444444444444444444444444444444444444444444444444440000000000000000000000000000000000000000000000
   00000000000000044444444444444444444444444444444444444444444444444444444444444444444444444444444444444444444000000000000000000000000000000000000000000
   00000000044444444444444111111111111111111111111111111111111111111111111111111111111111111111111111111111111400000000000000000000000000000000000000000
   00000000441111111111111111111111111111111111111111111111111111111111111111111111111111111111111111111111111440000000000000000000000000000000000000000
   00000000444111111111111111111111111111111111111111111111111111111111111111111111111111111111111111111111111144000000000000000000000000000000000000000
   00000000044411111111111111111111111111111111111111111111111111111111111111111111111111111111111111111111111114440000000000000000000000000000000000000
   00000000044111111111111111111111111111111111111111111111111111111111111111111111111111111111111111111111111114444000000000000000000000000000000000000
   00000000004444111111111111111111111111111111111111111111111111111111111111111111111111111111111111111111111111444400000000000000000000000000000000000
   00000000000004444111111111111111111111111111111111111111111111111111111111111111111111111111111111111111111111144440000000000000000000000000000000000
   00000000000000044444411111111111111111111111111111111111111111111111111111111111111111111111111111111111111111111140000000000000000000000000000000000
   00000000000000000044411111111111111111111111111111111111111111111111111111111111111111111111111111111111111111111144000000000000000000000000000000000
   00000000000000000000441111111111111111111111111111111111111111111111111111111111111111111111111111111111111111111444400000000000000000000000000000000
   00000000000000000000044411111111111111111111111111111111111111111111111111111111111111111111111111111111111111111144440000000000000000000000000000000
   00000000000000000000004441111111111111111111111111111111111111111111111111111111111111111111111111111111111111111144444000000000000000000000000000000
   00000000000000000000000044111111111111111111111111111111111111111111111111111111111111111111111111111111111111111114444000000000000000000000000000000
   00000000000000000000000004441111111111111111111111111111111111111111111111111111111111111111111111111111111111111111444400000000000000000000000000000
   00000000000000000000000000441111111111111111111111111111111111111111111111111111111111111111111111111111111111111111444440000000000000000000000000000
   00000000000000000000000000444111111111111111111111111111111111111111111111111111111111111111111111111111111111111111111440000000000000000000000000000
   00000000000000000000000000044411111111111111111111111111111111111111111111111111111111111111111111111111111111111111111444400000000000000000000000000
   00000000000000000000000000004444111111111111111111111111111111111111111111111111111111111111111111111111111111111111111444400000000000000000000000000
   00000000000000000000000000000044411111111111111111111111111111111111111111111111111111111111111111111111111111111111111114400000000000000000000000000
   00000000000000000000000000000004411111111111111111111111111111111111111111111111111111111111111111111111111111111111111144400000000000000000000000000
   00000000000000000000000000000000444111111111111111111111111111111111111111111111111111111111111111111111111111111111111144440000000000000000000000000
   00000000000000000000000000000044444441111111111111111111111111111111111111111111111111111111111111111111111111111111111144440000000000000000000000000
   00000000000000000000000000000444444444111111111111111111111111111111111111111111111111111111111111111111111111111111111114444000000000000000000000000
   00000000000000000000000000004444444444111111111111111111111111111111111111111111111111111111111111111111111111111111111414444400000000000000000000000
   00000000000000000000000000000044444444411111111111111111111111111111111111111111111111111111111111111111111111111111111144444400000000000000000000000
   00000000000000000000000000000000044444441111111111111111111111111111111111111111111111111111111111111111111111111111111144444400000000000000000000000
   00000000000000000000000000000000000044441111111111111111111111111111111111111111111111111111111111111111111111111111111111444440000000000000000000000
   00000000000000000000000000000000000000044111111111111111111111111111111111111111111111111111111111111111111111111111111144444440000000000000000000000
   00000000000000000000000000000000000000004411111111111111111111111111111111111111111111111111111111111111111111111111111144444440000000000000000000000
   00000000000000000000000000000000000000004441111111111111111111111111111111111111111111111111111111111111111111111111111114444440000000000000000000000
   00000000000000000000000000000000000000000444111111111111111111111111111111111111111111111111111111111111111111111111111114444440000000000000000000000
   00000000000000000000000000000000000000000044411111111111111111111111111111111111111111111111111111111111111111111111111144444400000000000000000000000
   00000000000000000000000000000000000000000000444111111111111111111111111111111111111111111111111111111111111111111111111444444000000000000000000000000
   00000000000000000000000000000000000000000000044441111111111111111111111111111111111111111111111111111111111111111111144444440000000000000000000000000
   00000000000000000000000000000000000000000000004441111111111111111111111111111111111111111111111111111111111111111114444444400000000000000000000000000
   00000000000000000000000000000000000000000000000444144111111111111111111111111111111111111111111111111111111111111144444440000000000000000000000000000
   00000000000000000000000000000000000000000000000000444411111111111111111111111111111111111111111111111111111111144444444000000000000000000000000000000
   00000000000000000000000000000000000000000000000000044444441441111111111111111111111111111111111111114444444444444444400000000000000000000000000000000
   00000000000000000000000000000000000000000000000000000000444444444444444444444444444444444444444444444440000000000000000000000000000000000000000000000
   00000000000000000000000000000000000000000000000000000000000000444444444444444444444444444444444000000000000000000000000000000000000000000000000000000
   00000000000000000000000000000000000000000000000000000000000000000000000000000000000000000000000000000000000000000000000000000000000000000000000000000
   00000000000000000000000000000000000000000000000000000000000000000000000000000000000000000000000000000000000000000000000000000000000000000000000000000
   00000000000000000000000000000000000000000000000000000000000000000000000000000000000000000000000000000000000000000000000000000000000000000000000000000
   00000000000000000000000000000000000000000000000000000000000000000000000000000000000000000000000000000000000000000000000000000000000000000000000000000
   00000000000000000000000000000000000000000000000000000000000000000000000000000000000000000000000000000000000000000000000000000000000000000000000000000