00000000000000000000000000000000000000000000000000000000000000000000000000000000000000000000000000000000000000000000000000000000000000000000000000000
00000000000000000000000000000000000000000000000000000000000000000000000000000000000000000000000000000000000000000000000000000000000000000000000000000
00000000000000000000000000000000000000000000000000000000000000000000000000000000000000000000000000000000000000000000000000000000000000000000000000000
00000000000000000000000000000000000000000000000000000000000000000000000000000000000000000000000000000000000000000000000000000000000000000000000000000
00000000000000000000000000000000000000000000000000000000000000000000000000000000000000000000000000000000000000000000000000000000000000000000000000000
00000000000000000000000000000000000000000000000000000000000000000000000000000000000000000000000000000000000000000000000000000000000000000000000000000
00000000000000000000000000000000000000000000000000000000000000000000000000000000000000000000000000000000000000000000000000000000000000000000000000000
00000000000000000000000000000000000000000000000000000000000000000000000000000000000000000000000000000000000000000000000000000000000000000000000000000
00000000000000000000044444444444444444444444444444444444444444444444444444444444444444444444444444444444444000000000000000000000000000000000000000000
00000000000000000044444233132133312213133222132131132323213121231132132211221131131131312122111333233232322400000000000000000000000000000000000000000
00000000000000000444331221112221333122323331113313322122112321332132112112232312322131223122313223223331111440000000000000000000000000000000000000000
00000000000000000423222321221212112332322233322223212121221131233113112212122221322211232322212233232113211244000000000000000000000000000000000000000
00000000000000000421111113131313111223223222233211132321313223223332333332323233231231132231223112311312132324440000000000000000000000000000000000000
00000000000000000422133322221113222313312132133323321131222321232211123131133323122313313312133112222323311314444000000000000000000000000000000000000
00000000000000000044322221333121212213231121231311122133133223223212212133112213211221132133312321232231321323444400000000000000000000000000000000000
00000000000000000044323121133133213123233331111212312333221331221132122233131123132332213221231113213311332233344440000000000000000000000000000000000
00000000000000000000412311123222112331311211312232133131332131133113213213323133131311112111123331112123231133331340000000000000000000000000000000000
00000000000000000000031112112332113212322311232322311222133332312112113111222113112222122121111211123111132321223244000000000000000000000000000000000
00000000000000000000003313223312333331312321131321231121112322233221122231323131312223132332313133223231122123312444400000000000000000000000000000000
00000000000000000000000412232232313221113313223311112123131223313111132131332233331121122233131231311121221222313144440000000000000000000000000000000
00000000000000000000000042113121323212232323211212132311213132112312112212312233133233133233332313312122323311223344444000000000000000000000000000000
00000000000000000000000004232322221111221333223122322333133211322133122221313312231331112112131131312322121122231114444000000000000000000000000000000
00000000000000000000000000443123211122223121212131213112123211332323211311232131222131111133211123132331322132222133444400000000000000000000000000000
00000000000000000000000000043113213132121333212112212332313113213323122323332223322232323222312223122322331233132111444400000000000000000000000000000
00000000000000000000000000044211131312122211323312333113133223321112332221231211332213131223123311211112311211332113121400000000000000000000000000000
00000000000000000000000000004431232322321131123131331122333131123123332211223222332132221121321333121313233221322323312424400000000000000000000000000
00000000000000000000000000000444131121111322232211111212321113112213331311312311331321312133223223232113231112211223213444400000000000000000000000000
00000000000000000000000000000004432211111122133131231123321213213211122313121211223111333322333131332132312121232111112334400000000000000000000000000
00000000000000000000000000000004411233323223212233232321122221223133222112232311112333232331321123222233213321123333131344400000000000000000000000000
00000000000000000000000000000000443133113312131231312131221233331332311323123231113231133112323222133133232133113113233244440000000000000000000000000
00000000000000000000000000000000044133131322121111231322323123122113223222132213131311213221312221232212333213222212121144440000000000000000000000000
00000000000000000000000000000000004413231213312132333232313113132231323333212222311211323313322313223221121213132232121314444000000000000000000000000
00000000000000000000000000000000004311323112233333322111111333113331113212311231121111213123332121321112212221131223133424440400000000000000000000000
00000000000000000000000000000000000044121123321112331322113333231123231231111323311212113311232331312122132133231222112144444400000000000000000000000
00000000000000000000000000000000000044432313322123231323111213231331312311131221123332112111232323123212312122311221132144440400000000000000000000000
00000000000000000000000000000000000000441231131331123332312123313332113122231132133222223131113123222132123111213223132323444000000000000000000000000
00000000000000000000000000000000000000044223221111132131212331221121313123122123312322322113233221223312311323333113111144444400000000000000000000000
00000000000000000000000000000000000000004413212211121222222132211313113232112121131211323231213211311233111333212211111144444400000000000000000000000
00000000000000000000000000000000000000004443213323112212313313232321133221333221231323311222111132313131223122312131311224444400000000000000000000000
00000000000000000000000000000000000000000444323131132313231121323311321313132313113321123223113321322232213231311113313114444400000000000000000000000
00000000000000000000000000000000000000000044431111131121212231312223323123223221332223321311211133332212123133121221222144444000000000000000000000000
00000000000000000000000000000000000000000000444113212221233223133133212232333232232333121113112222312222322111212321312441300000000000000000000000000
00000000000000000000000000000000000000000000044443222312331113212332131331132231221213233331123333112123223121222213344411000000000000000000000000000
00000000000000000000000000000000000000000000004441122123212333222123111211332233322123211312233233133111112332233214444201000000000000000000000000000
00000000000000000000000000000000000000000000000444344331311321131313323333333222231322311122323231332132133331333344440000000000000000000000000000000
00000000000000000000000000000000000000000000000000444432123231131222113231231331112212111323221112211323211223144434000000000000000000000000000000000
00000000000000000000000000000000000000000000000000044444442441212321131331131111133231312321212313124444444444444400000000000000000000000000000000000
00000000000000000000000000000000000000000000000000000000444444444444444444444444444444444444444444440000000000000000000000000000000000000000000000000
00000000000000000000000000000000000000000000000000000000000000444444444444444444444444444444444000000000000000000000000000000000000000000000000000000
00000000000000000000000000000000000000000000000000000000000000000000000000000000000000000000000000000000000000000000000000000000000000000000000000000
00000000000000000000000000000000000000000000000000000000000000000000000000000000000000000000000000000000000000000000000000000000000000000000000000000
00000000000000000000000000000000000000000000000000000000000000000000000000000000000000000000000000000000000000000000000000000000000000000000000000000
00000000000000000000000000000000000000000000000000000000000000000000000000000000000000000000000000000000000000000000000000000000000000000000000000000
00000000000000000000000000000000000000000000000000000000000000000000000000000000000000000000000000000000000000000000000000000000000000000000000000000
