0303020103020103
0103010301020203
0203020102010202
0202030103030302
0101010102030302
0302020101030302
0101020301030203
0303020303030303
