00000000000000000000000000000000000000000000000000000000000000000000000000000000000000000000000000000000000000000000000000000000000000000000000000000
00000000000000000000000000000000000000000000000000000000000000000000000000000000000000000000000000000000000000000000000000000000000000000000000000000
00000000000000000000000000000000000000000000000000000000000000000000000000000000000000000000000000000000000000000000000000000000000000000000000000000
00000000000000000000000000000000000000000000000000000000000000000000000000000000000000000000000000000000000000000000000000000000000000000000000000000
00000000000000000000000000000000000000000000000000000000000000000000000000000000000000000000000000000000000000000000000000000000000000000000000000000
00000000000000000000000000000000000000000000000000000000000000000000000000000000000000000000000000000000000000000000000000000000000000000000000000000
00000000000000000000000000000000000000000000000000000000000000000000000000000000000000000000000000000000000000000000000000000000000000000000000000000
00000000000000000000000000000000000000000000000000000000000000000000000000000000000000000000000000000000000000000000000000000000000000000000000000000
00000000000000000000044444444444444444444444444444444444444444444444444444444444444444444444444444444444444000000000000000000000000000000000000000000
00000000000000000044444313333333313313231133233111311133321223221311232131113221221133212221231213121312322400000000000000000000000000000000000000000
00000000000000000444213331312222113321212323322331332113121221221213323113212111211211232111221231323213123440000000000000000000000000000000000000000
00000000000000000431212132133123113112333131232132221122223112323133113123321312331212321332231321213113223244000000000000000000000000000000000000000
00000000000000000432133213231313111223321232311322321312213111112322222132131313231211312312223133213121111114440000000000000000000000000000000000000
00000000000000000431232333133312113333331312333133212112112232332323231132212111313211312113121231223311213124444000000000000000000000000000000000000
00000000000000000044321321212222111223323213333131331223223211133213133321222222231222121332221111121332221322444400000000000000000000000000000000000
00000000000000000044212132233123223221131231312112332112233233331221223322323322223332113212121113311122232311144440000000000000000000000000000000000
00000000000000000000422122323231211122132121131321112332313231332112113331322121333231123311123121232312321113121240000000000000000000000000000000000
00000000000000000000032322313323131333321111312332121223322131332222112121321313123132322121312321332223123331232144000000000000000000000000000000000
00000000000000000000003222322313123312232212332223311212213223332222332133132322123313211222213333333313132232331444400000000000000000000000000000000
00000000000000000000000433131221121232113132112113223313122113121233112333111122233223312122222122222112131212311344440000000000000000000000000000000
00000000000000000000000041333232112212221232331212211111122223331222222133213112311223111322322333231113123331333344444000000000000000000000000000000
00000000000000000000000004123312322212113311322133131332131313213222322121231111212213231231211111223221132222122114444000000000000000000000000000000
00000000000000000000000000441211321122331112221322112112231333122213332211222113322133123333311131121313233133123212444400000000000000000000000000000
00000000000000000000000000043132131232321223122132113333223332332132322231231221131313221121221321122133132321122322444400000000000000000000000000000
00000000000000000000000000044321213213321231232132313132221333321312313212121133322323111322122332322332321123233312221400000000000000000000000000000
00000000000000000000000000004431222222121213113312321331122231313213311313123132222213213231331323322223123222212213312414400000000000000000000000000
00000000000000000000000000000444113122313112123332321212233331122213222322232113121121122221121231323323133121231323312444400000000000000000000000000
00000000000000000000000000000004412112121231133123213311122131221111121122132122111111223222211321233311121321322313221234400000000000000000000000000
00000000000000000000000000000004421212131223312213312313133122231112221121212122333232121322113221232132133211221113122344400000000000000000000000000
00000000000000000000000000000000443133211122111321223222311232211213323311331232211232131131111313112132313331133123122144440000000000000000000000000
00000000000000000000000000000000044333113131311222221133313332321211121221232312233313333321321132113111231233133111131144440000000000000000000000000
00000000000000000000000000000000004422233333123212112312233312222313122133232132231212221313131122211321311221221213233324444000000000000000000000000
00000000000000000000000000000000004123312332233231333111233112322211332223133113121222212132222323333131312323332211132434440400000000000000000000000
00000000000000000000000000000000000044323313113311132231333211332133223221223132333223323322323221221132322213311213223144444400000000000000000000000
00000000000000000000000000000000000044412332331313112321311331212212211213112133122112133222112133322123133122111332321244440400000000000000000000000
00000000000000000000000000000000000000443321332121232112331233222121323213333133211231323332123331313112333113333233321113444000000000000000000000000
00000000000000000000000000000000000000044133231323121232131112231121331121233121212213223131123323113233233232123221231144444400000000000000000000000
00000000000000000000000000000000000000004411131221312312213131111121221321121133112211232121132323333132131331131233132144444400000000000000000000000
00000000000000000000000000000000000000004442311112213323121131323332121332312222111321231313312221122211121233323233222334444400000000000000000000000
00000000000000000000000000000000000000000444121322311112113123332222331113211221331133231333233123331232312321211323233114444400000000000000000000000
00000000000000000000000000000000000000000044413212223321232122213122121321111122131112133123222323133231311312322311322244444000000000000000000000000
00000000000000000000000000000000000000000000444321332223113311131311333332223123122113122112232132112113331222223333122442100000000000000000000000000
00000000000000000000000000000000000000000000044443221223223332131121111122333233221211122113322231132122332333313132344421000000000000000000000000000
00000000000000000000000000000000000000000000004442213321323133112233223212121322312112121322212322211331213212111234444301000000000000000000000000000
00000000000000000000000000000000000000000000000444344331321311331222121223213212223132232211112321112123122333323144440000000000000000000000000000000
00000000000000000000000000000000000000000000000000444412223121133322222321131122323223121132112221233222331332344414000000000000000000000000000000000
00000000000000000000000000000000000000000000000000044444441442122121212332122313112211232221133113114444444444444400000000000000000000000000000000000
00000000000000000000000000000000000000000000000000000000444444444444444444444444444444444444444444440000000000000000000000000000000000000000000000000
00000000000000000000000000000000000000000000000000000000000000444444444444444444444444444444444000000000000000000000000000000000000000000000000000000
00000000000000000000000000000000000000000000000000000000000000000000000000000000000000000000000000000000000000000000000000000000000000000000000000000
00000000000000000000000000000000000000000000000000000000000000000000000000000000000000000000000000000000000000000000000000000000000000000000000000000
00000000000000000000000000000000000000000000000000000000000000000000000000000000000000000000000000000000000000000000000000000000000000000000000000000
00000000000000000000000000000000000000000000000000000000000000000000000000000000000000000000000000000000000000000000000000000000000000000000000000000
00000000000000000000000000000000000000000000000000000000000000000000000000000000000000000000000000000000000000000000000000000000000000000000000000000
