0302010303010301
0201020202010102
0103010202030103
0203010201030302
0302020201030203
0302020103020102
0301010202020302
0302020103030202
