00000000000000000000000000000000000000000000000000000000000000000000000000000000000000000000000000000000000000000000000000000000000000000000000000000
00000000000000000000000000000000000000000000000000000000000000000000000000000000000000000000000000000000000000000000000000000000000000000000000000000
00000000000000000000000000000000000000000000000000000000000000000000000000000000000000000000000000000000000000000000000000000000000000000000000000000
00000000000000000000000000000000000000000000000000000000000000000000000000000000000000000000000000000000000000000000000000000000000000000000000000000
00000000000000000000000000000000000000000000000000000000000000000000000000000000000000000000000000000000000000000000000000000000000000000000000000000
00000000000000000000000000000000000000000000000000000000000000000000000000000000000000000000000000000000000000000000000000000000000000000000000000000
00000000000000000000000000000000000000000000000000000000000000000000000000000000000000000000000000000000000000000000000000000000000000000000000000000
00000000000000000000000000000000000000000000000000000000000000000000000000000000000000000000000000000000000000000000000000000000000000000000000000000
00000000000000000000044444444444444444444444444444444444444444444444444444444444444444444444444444444444444000000000000000000000000000000000000000000
00000000000000000044444212221231311212131331122313231113233321132213132331323123131213233332123233212213322400000000000000000000000000000000000000000
00000000000000000444211123311223223123322222122123232111112333213323233223121122122133233112133331332232121440000000000000000000000000000000000000000
00000000000000000421211122113323211311123311331221212131321321313213132311311311122212233211233333221332323344000000000000000000000000000000000000000
00000000000000000432123231213313232322312323313333221223111321231332323323223231231233211123222311322221322124440000000000000000000000000000000000000
00000000000000000433211212132311331331122133332211133222211323311222121312332332211233221313221313233333231214444000000000000000000000000000000000000
00000000000000000044132223132313232332311133213333212112123323313212323113221223211332313312232132323122313131444400000000000000000000000000000000000
00000000000000000044232111132112112131121333332333223212311212112232133231211313222322122122321222112322311313144440000000000000000000000000000000000
00000000000000000000422212112122113323322233212132231133132131223311312221112331213232321222322121311323332322213340000000000000000000000000000000000
00000000000000000000011132231323321322111313323113332132312132131331133212121132321231321311111212232331131111322144000000000000000000000000000000000
00000000000000000000003331222113112331232332333333121111122132213111222212232231231133212323232131113332111221112444400000000000000000000000000000000
00000000000000000000000422221111123122113332231221211332233121123213121322323111331233233131133132111212112233233344440000000000000000000000000000000
00000000000000000000000042121232322232131332121313121232311122122313312233311333221211112322132311313331212112321344444000000000000000000000000000000
00000000000000000000000004312121231323121121213313131111121333112132211323112233121312313332223132312331232133131214444000000000000000000000000000000
00000000000000000000000000442223331112121313112221211222313212122123133232313333233311231112113111222323131132132313444400000000000000000000000000000
00000000000000000000000000042122331311321222213133331132223132233133313222221333312331211232221222123123213111311323444400000000000000000000000000000
00000000000000000000000000044312312312111311123233111123133131323323223331311231212113313131223121132312121121311123211400000000000000000000000000000
00000000000000000000000000004413313121332333122223223212232133212323333311133231111311233313213111222112111311313311212424400000000000000000000000000
00000000000000000000000000000444212221212212231112211221121212312311312332233113221321311312322233321111333333221311123444400000000000000000000000000
00000000000000000000000000000004412133311213132323312322322112333121312131111333123321323322213322112212122223131111321124400000000000000000000000000
00000000000000000000000000000004432233131132123211123223121111213133133111121132213312232113321112212132123321331321121244400000000000000000000000000
00000000000000000000000000000000443211323313231233323313221111121131331113121331221311313112113221232133212133211222132344440000000000000000000000000
00000000000000000000000000000000044313222112231321332112311221112321332131121332321321232131121213233323211333221312112344440000000000000000000000000
00000000000000000000000000000000004431332322111121232323111222331322233321332123232322221222311323233121313123123112112234444000000000000000000000000
00000000000000000000000000000000004133312133222212121333323311223131331223111322313333232123233313111223133113322123212424440400000000000000000000000
00000000000000000000000000000000000044133322232113112121311211121221123223121213223122223213111223313331112333311233211344444400000000000000000000000
00000000000000000000000000000000000044433223133333232122311131131113231223223211321313322323333211211131231211312131322244440400000000000000000000000
00000000000000000000000000000000000000443231231212211121223333223322113312222211123231222223321223323112131222331331321233444000000000000000000000000
00000000000000000000000000000000000000044322222123223223321321211122111113322133211232233122131131113233312133112321133344444400000000000000000000000
00000000000000000000000000000000000000004421111212331232221212331232221123233222121233111211121213123313321123233322333144444400000000000000000000000
00000000000000000000000000000000000000004441213332112223132221232332231311232321211211211212211221122223312311331331213214444400000000000000000000000
00000000000000000000000000000000000000000444122123113333112311313222132223112223312223321322113121322331333322312121212124444400000000000000000000000
00000000000000000000000000000000000000000044433222231122212311311132311112112332312332131332131123313213112113333312122144444000000000000000000000000
00000000000000000000000000000000000000000000444121313111323333113112213312132331211122313122221332121123133132333223313443200000000000000000000000000
00000000000000000000000000000000000000000000044441223323232111232233233323333323213212321112212132122112211211332111344422000000000000000000000000000
00000000000000000000000000000000000000000000004441212231221111322121313123232333222123321131121223122213113312312134444103000000000000000000000000000
00000000000000000000000000000000000000000000000444244133221331312231111322223323113111122112333331121321112222231144440000000000000000000000000000000
00000000000000000000000000000000000000000000000000444421311113322213123231211312221111323332221122132112112222144434000000000000000000000000000000000
00000000000000000000000000000000000000000000000000044444443441231313132321132111121233221212113132324444444444444400000000000000000000000000000000000
00000000000000000000000000000000000000000000000000000000444444444444444444444444444444444444444444440000000000000000000000000000000000000000000000000
00000000000000000000000000000000000000000000000000000000000000444444444444444444444444444444444000000000000000000000000000000000000000000000000000000
00000000000000000000000000000000000000000000000000000000000000000000000000000000000000000000000000000000000000000000000000000000000000000000000000000
00000000000000000000000000000000000000000000000000000000000000000000000000000000000000000000000000000000000000000000000000000000000000000000000000000
00000000000000000000000000000000000000000000000000000000000000000000000000000000000000000000000000000000000000000000000000000000000000000000000000000
00000000000000000000000000000000000000000000000000000000000000000000000000000000000000000000000000000000000000000000000000000000000000000000000000000
00000000000000000000000000000000000000000000000000000000000000000000000000000000000000000000000000000000000000000000000000000000000000000000000000000
