00000000000000000000000000000000000000000000000000000000000000000000000000000000000000000000000000000000000000000000000000000000000000000000000000000
00000000000000000000000000000000000000000000000000000000000000000000000000000000000000000000000000000000000000000000000000000000000000000000000000000
00000000000000000000000000000000000000000000000000000000000000000000000000000000000000000000000000000000000000000000000000000000000000000000000000000
00000000000000000000000000000000000000000000000000000000000000000000000000000000000000000000000000000000000000000000000000000000000000000000000000000
00000000000000000000000000000000000000000000000000000000000000000000000000000000000000000000000000000000000000000000000000000000000000000000000000000
00000000000000000000000000000000000000000000000000000000000000000000000000000000000000000000000000000000000000000000000000000000000000000000000000000
00000000000000000000000000000000000000000000000000000000000000000000000000000000000000000000000000000000000000000000000000000000000000000000000000000
00000000000000000000000000000000000000000000000000000000000000000000000000000000000000000000000000000000000000000000000000000000000000000000000000000
00000000000000000000044444444444444444444444444444444444444444444444444444444444444444444444444444444444444000000000000000000000000000000000000000000
00000000000000000044444232132312223211312132212322131122222223332113131313211312332122132233111333223232322400000000000000000000000000000000000000000
00000000000000000444312133331233323131131232113332311113132133111321213213212221313112231123332222132121313440000000000000000000000000000000000000000
00000000000000000421233213222232121321311213112132231311111221132112311321311221233321232211312322213331221344000000000000000000000000000000000000000
00000000000000000411133123213333131113112313333212221232211223322321323212112213231212232331221312132333121224440000000000000000000000000000000000000
00000000000000000412232322222313133313222222322113313223321233133331111112331132111213113222321231133122223234444000000000000000000000000000000000000
00000000000000000044233313333323111121331121132311312132122133112123112232121231332122321111311233322231312331444400000000000000000000000000000000000
00000000000000000044332113331211311122123331332122132332322333212112211213133221112321133221121331122331212323144440000000000000000000000000000000000
00000000000000000000421333232132322211312133233213111313321112221331323231123311121212131121111132131313132111223240000000000000000000000000000000000
00000000000000000000023322121211121113211112211313311331323313132232133231231132112333211333323323213121332323113344000000000000000000000000000000000
00000000000000000000001313321233312312322323131121212231331332211122112131233322223213333132311332323121233232221444400000000000000000000000000000000
00000000000000000000000422231212111112112133212212232321133132322222233332333123223323213222332213232121331321232244440000000000000000000000000000000
00000000000000000000000042212233321123133121132311111321213331212331221121133333322112122313112312113213323333333144444000000000000000000000000000000
00000000000000000000000004123331132331122121122233121331131332233333132323331322311123121112332131233231311133212134444000000000000000000000000000000
00000000000000000000000000443213123331113132332221322223232213212111332132221113322131131231232232132213223112133311444400000000000000000000000000000
00000000000000000000000000041221332211313131312332323213233313111333231222131333212232232113113332333312222121122313444400000000000000000000000000000
00000000000000000000000000044223221332221131212122313212321132223122333212132322111212323321113112322111311121113323223400000000000000000000000000000
00000000000000000000000000004432223322312221112332211332333121331213221332331231122111231333333231332222132212221312221424400000000000000000000000000
00000000000000000000000000000444332312312332321133132233212221113221311332211212121333231232323121222321323313333313123444400000000000000000000000000
00000000000000000000000000000004433222233131233323123131333133322331323131112233222313311123312233323332231333313132113224400000000000000000000000000
00000000000000000000000000000004421123221221312121222111333121332312312313321231122313111311212121121332212233112313322344400000000000000000000000000
00000000000000000000000000000000443222321321323121123122122112112113213133331122322322123112232122313212322331333132223144440000000000000000000000000
00000000000000000000000000000000044222122211221322231221311322333332222222233333122122221113123132333232111333211233133244440000000000000000000000000
00000000000000000000000000000000004423313333231211321323223113223121232231231112331331333121133112112211132321312323223324444000000000000000000000000
00000000000000000000000000000000004212121122111333232233123321213112311222221222223123312322121313131133112221313321322414440400000000000000000000000
00000000000000000000000000000000000044313113332222232113321122123311211112113232232311132312221131332113221133131332223144444400000000000000000000000
00000000000000000000000000000000000044412223212223132213311311211211112223313211322323312111123131221113223232222321332244440400000000000000000000000
00000000000000000000000000000000000000443321233332313122133123113222212312323122323233123322233331311123332122312321322232444000000000000000000000000
00000000000000000000000000000000000000044232231232232223112321311131211222211312112222322132121311331332322123232111321144444400000000000000000000000
00000000000000000000000000000000000000004423131231312123322322222131123111223323122232313123132333123313122312123223211244444400000000000000000000000
00000000000000000000000000000000000000004442132322111332321131222133121112211111132221233322312121331311332223113133122114444400000000000000000000000
00000000000000000000000000000000000000000444123132122111222132333123122231221121121321231132113311222322122122131212122134444400000000000000000000000
00000000000000000000000000000000000000000044412112133233131123311112131233221132121122231121122121312121232311133332121144444000000000000000000000000
00000000000000000000000000000000000000000000444323312223313311213113323232213231133223213231223213321132213313231331131443100000000000000000000000000
00000000000000000000000000000000000000000000044442211222332321333111231111213131221211313333211313223333332312312213144412000000000000000000000000000
00000000000000000000000000000000000000000000004443313121121321331131313231121312212333333232211233213133311123232224444301000000000000000000000000000
00000000000000000000000000000000000000000000000444244232112211131123132133221113121331321232121311313112112133233144440000000000000000000000000000000
00000000000000000000000000000000000000000000000000444411231321233112322322322123133331113223133132133213311331244424000000000000000000000000000000000
00000000000000000000000000000000000000000000000000044444441443322331112312112111112122232332133122314444444444444400000000000000000000000000000000000
00000000000000000000000000000000000000000000000000000000444444444444444444444444444444444444444444440000000000000000000000000000000000000000000000000
00000000000000000000000000000000000000000000000000000000000000444444444444444444444444444444444000000000000000000000000000000000000000000000000000000
00000000000000000000000000000000000000000000000000000000000000000000000000000000000000000000000000000000000000000000000000000000000000000000000000000
00000000000000000000000000000000000000000000000000000000000000000000000000000000000000000000000000000000000000000000000000000000000000000000000000000
00000000000000000000000000000000000000000000000000000000000000000000000000000000000000000000000000000000000000000000000000000000000000000000000000000
00000000000000000000000000000000000000000000000000000000000000000000000000000000000000000000000000000000000000000000000000000000000000000000000000000
00000000000000000000000000000000000000000000000000000000000000000000000000000000000000000000000000000000000000000000000000000000000000000000000000000
