0202020302020101
0103020103030301
0201030302030201
0302030201030302
0201030301010302
0303020102010103
0101010102030302
0302010102030203
