0301010303030101
0301020301030101
0201020102030303
0303020101020103
0302020201030301
0102030102020203
0201030102010303
0102030203020303
