00000000000000000000000000000000000000000000000000000000000000000000000000000000000000000000000000000000000000000000000000000000000000000000000000000
00000000000000000000000000000000000000000000000000000000000000000000000000000000000000000000000000000000000000000000000000000000000000000000000000000
00000000000000000000000000000000000000000000000000000000000000000000000000000000000000000000000000000000000000000000000000000000000000000000000000000
00000000000000000000000000000000000000000000000000000000000000000000000000000000000000000000000000000000000000000000000000000000000000000000000000000
00000000000000000000000000000000000000000000000000000000000000000000000000000000000000000000000000000000000000000000000000000000000000000000000000000
00000000000000000000000000000000000000000000000000000000000000000000000000000000000000000000000000000000000000000000000000000000000000000000000000000
00000000000000000000000000000000000000000000000000000000000000000000000000000000000000000000000000000000000000000000000000000000000000000000000000000
00000000000000000000000000000000000000000000000000000000000000000000000000000000000000000000000000000000000000000000000000000000000000000000000000000
00000000000000000000044444444444444444444444444444444444444444444444444444444444444444444444444444444444444000000000000000000000000000000000000000000
00000000000000000044444331212331311122211221221132333213112122332122121111321131112113121312313111221332131400000000000000000000000000000000000000000
00000000000000000444311132211221112211123313222311233123323211331223312111123223212333222132131221311123232440000000000000000000000000000000000000000
00000000000000000423212232112331322123123213131211213132322212232213133113112313113123231111312331123131222344000000000000000000000000000000000000000
00000000000000000422321332322123132332331111221333331113111122322322132123131311322333232233233131112333321234440000000000000000000000000000000000000
00000000000000000413321312222212322231113332223213131112231112321122221133112111232123221223311321131212233314444000000000000000000000000000000000000
00000000000000000044221211231232311332233122221121213221113213113213232322311213213131111322311222322232213333444400000000000000000000000000000000000
00000000000000000044131231323312112222212331131221312112333122212323221113323121121221131231111221211113333333344440000000000000000000000000000000000
00000000000000000000432121221223221331133223123123133322132232212121131213112211212331111232233331211322233121222240000000000000000000000000000000000
00000000000000000000032322232232233112112323211232112113232323132232331223333131233321123112132122223121333213231144000000000000000000000000000000000
00000000000000000000001312312333322111132122321122132221332213323223311112231232321222312112111233312222212311223444400000000000000000000000000000000
00000000000000000000000433311311131312321122223322212222212322133231233133213332211223212311233311222223322313133244440000000000000000000000000000000
00000000000000000000000042232132333112312313213111331113333211323233322211233323122322113312122332332213333322122144444000000000000000000000000000000
00000000000000000000000004311122311132223323111121121212323232121313111113321121323311111122121332121313112212312214444000000000000000000000000000000
00000000000000000000000000441312112122122313333133133232111133332133213321111213223323232332213223331113331223121122444400000000000000000000000000000
00000000000000000000000000043322213212223322222323122323212112212131111322321331333323323221213231212222323313232231444400000000000000000000000000000
00000000000000000000000000044332123311311331131231121223321112331331323122233223323312231123211312323322322221213222323400000000000000000000000000000
00000000000000000000000000004411323313111333322113112112222112321321333322123323123313332321232311322133213132332113323414400000000000000000000000000
00000000000000000000000000000444321132233323231333221332133131312131123313211211131221211321223233113331233331132111323444400000000000000000000000000
00000000000000000000000000000004423131223111312133221111222111111121322213113322311333222322313123233331311322232112332134400000000000000000000000000
00000000000000000000000000000004413213231131232331331321113111322333211112122133132111223131233231312211331112323312222144400000000000000000000000000
00000000000000000000000000000000443221233123323212331122122132232331231313123313222313313311111323222222312231321311321144440000000000000000000000000
00000000000000000000000000000000044112311311113111113132322311223323211331221311131121221233333332131222231313223233231144440000000000000000000000000
00000000000000000000000000000000004433133211321223323211221212211121213232113232132333313133212112232123232221312311231234444000000000000000000000000
00000000000000000000000000000000004313112311312212122222221321312213321332223113331212332123122122233212211121322223231434440400000000000000000000000
00000000000000000000000000000000000044223231231122113131312333222212231313323322221222332322211311111211132133121113213344444400000000000000000000000
00000000000000000000000000000000000044432232112323222232223111231331111111333221311331233223112213232212312233323123333344440400000000000000000000000
00000000000000000000000000000000000000443332223122212312212312221213332132222313113113223212123211223322121212222321231123444000000000000000000000000
00000000000000000000000000000000000000044131123222133213122212231311131123131223322133231313213123112123313213221313121144444400000000000000000000000
00000000000000000000000000000000000000004432122312211111123232123321111331232122232212123133311113332123323322332133122244444400000000000000000000000
00000000000000000000000000000000000000004441132133332311212212313213213321313132313332233233121313233111132333313222333234444400000000000000000000000
00000000000000000000000000000000000000000444232232122321232213111232111312121223132131123221321333312313122231111232232334444400000000000000000000000
00000000000000000000000000000000000000000044432122311113332132111311313212213233232222113213133111223123231221312221312344444000000000000000000000000
00000000000000000000000000000000000000000000444122332222133222112222123231133113211333322131133231233112211131112321311442300000000000000000000000000
00000000000000000000000000000000000000000000044442221132112331223331232332321131312231221131113232233133113323223313144411000000000000000000000000000
00000000000000000000000000000000000000000000004442123131232222223132322233112311322231322123123313112231113221322314444203000000000000000000000000000
00000000000000000000000000000000000000000000000444344123333121132332323331221321113323132333313311123113113213111144440000000000000000000000000000000
00000000000000000000000000000000000000000000000000444411221221223221311333221112233221213333131132231311132113344424000000000000000000000000000000000
00000000000000000000000000000000000000000000000000044444443442132232121122211311222122131223123233134444444444444400000000000000000000000000000000000
00000000000000000000000000000000000000000000000000000000444444444444444444444444444444444444444444440000000000000000000000000000000000000000000000000
00000000000000000000000000000000000000000000000000000000000000444444444444444444444444444444444000000000000000000000000000000000000000000000000000000
00000000000000000000000000000000000000000000000000000000000000000000000000000000000000000000000000000000000000000000000000000000000000000000000000000
00000000000000000000000000000000000000000000000000000000000000000000000000000000000000000000000000000000000000000000000000000000000000000000000000000
00000000000000000000000000000000000000000000000000000000000000000000000000000000000000000000000000000000000000000000000000000000000000000000000000000
00000000000000000000000000000000000000000000000000000000000000000000000000000000000000000000000000000000000000000000000000000000000000000000000000000
00000000000000000000000000000000000000000000000000000000000000000000000000000000000000000000000000000000000000000000000000000000000000000000000000000
