00000000000000000000000000000000000000000000000000000000000000000000000000000000000000000000000000000000000000000000000000000000000000000000000000000
00000000000000000000000000000000000000000000000000000000000000000000000000000000000000000000000000000000000000000000000000000000000000000000000000000
00000000000000000000000000000000000000000000000000000000000000000000000000000000000000000000000000000000000000000000000000000000000000000000000000000
00000000000000000000000000000000000000000000000000000000000000000000000000000000000000000000000000000000000000000000000000000000000000000000000000000
00000000000000000000000000000000000000000000000000000000000000000000000000000000000000000000000000000000000000000000000000000000000000000000000000000
00000000000000000000000000000000000000000000000000000000000000000000000000000000000000000000000000000000000000000000000000000000000000000000000000000
00000000000000000000000000000000000000000000000000000000000000000000000000000000000000000000000000000000000000000000000000000000000000000000000000000
00000000000000000000044444444444444444444444444444444444444444444444444444444444444444444444444444444440000000000000000000000000000000000000000000000
00000000000000044444444444444444444444444444444444444444444444444444444444444444444444444444444444444444444000000000000000000000000000000000000000000
00000000044444444444444323211322213212231113332233122332212211321212131321323113213211112321333113311213323400000000000000000000000000000000000000000
00000000443211311212323332111323123212112111111132123123123322221121212122221333312332321323121321131232222440000000000000000000000000000000000000000
00000000444123211322132322232122211113311232123122222321221333131113313212233333232232223111323132212331223244000000000000000000000000000000000000000
00000000044412323111312131221131332123212311122331332312333333221312321121121331231313221121321331321233331134440000000000000000000000000000000000000
00000000044332321133223113223112312221123111322311233322212331313333231323321312233121123213111132332211231214444000000000000000000000000000000000000
00000000004444333131122132233311233323222321333131323312112322323333231223333333221211312311132133233133311233444400000000000000000000000000000000000
00000000000004444212133223311122333212213332111112212313212322233133211331122332231233133222233131331312312131244440000000000000000000000000000000000
00000000000000044444431131123222311313323131222222333121321313233133121312123312322121331121311131332212322322133140000000000000000000000000000000000
00000000000000000044423231221332221221313221123231211322211133313322331121332113333131113333111223112112311232122244000000000000000000000000000000000
00000000000000000000441233132113332122111213321213212121233212231233223122231313221311213332332121321223133322321444400000000000000000000000000000000
00000000000000000000044413232332212122131333322121233231133133333322133212321321312311212332233132332123313123313244440000000000000000000000000000000
00000000000000000000004442121321111313333323133133122113133323122123222233223112221332323111113212133211323332233244444000000000000000000000000000000
00000000000000000000000044333323312332322112123131121231321111123221221212223123322112133231233211122222132123111214444000000000000000000000000000000
00000000000000000000000004443113123111321231333321212221133332322233331312323212122332113212222232313313211233233323444400000000000000000000000000000
00000000000000000000000000442231323231333132232312233122122123211223313331133213312311323333223313223132222121322333444440000000000000000000000000000
00000000000000000000000000444312132212333312332223123313133121111233313222222233123113132331113323322222123333111112131440000000000000000000000000000
00000000000000000000000000044411112131133213121221223231322123221121222331232212313231333233231312121133333232112223313444400000000000000000000000000
00000000000000000000000000004444332211121231211322311313122311131212132323221123231212233133132223132121112321221323323444400000000000000000000000000
00000000000000000000000000000044422211132231313132332123113331231321211223323121313332211332331113113332331233312113223234400000000000000000000000000
00000000000000000000000000000004432322313121323111112322231233233213133321122213323232231123112323222232223132212233331344400000000000000000000000000
00000000000000000000000000000000443332332131231231122132221221221333321312221221323312112122212321231212231223121231133244440000000000000000000000000
00000000000000000000000000000000044232132212231311122322222331231211223311123131331322213112313331132113211133322231111344440000000000000000000000000
00000000000000000000000000000000004412231232332132311321231311133111232213311121122333213312233113333112312132113221213324444000000000000000000000000
00000000000000000000000000000000004131111233233112313231113133321133322223332132221132211332213111212332211222132313323434444400000000000000000000000
00000000000000000000000000000000000044223331322223112331212111131232111122121311132331132222323213311121211212223233331144444400000000000000000000000
00000000000000000000000000000000000044422233222223133121121322313211331221133331133211222332331211132113322122221233132144444400000000000000000000000
00000000000000000000000000000000000000441211232121312113113331122232333212131322111123212312113311311331111113321132321311444440000000000000000000000
00000000000000000000000000000000000000044322232321123133321221311211131311133123122321311312121133113221232332122221312344444440000000000000000000000
00000000000000000000000000000000000000004433212131211222131333131133331132212323131231333233313333213133332332121222123344444440000000000000000000000
00000000000000000000000000000000000000004443212223212322321222123221232113231123213132112323322233221112231332233213322214444440000000000000000000000
00000000000000000000000000000000000000000444221232232321323132312222113223133232312223332321231313313132212131233132332214444440000000000000000000000
00000000000000000000000000000000000000000044431111112123223333123223131131211333321212313332133232223122321212113323323244444400000000000000000000000
00000000000000000000000000000000000000000000444333111221121122323223122332233311312313212133331111131122321311122121222444444000000000000000000000000
00000000000000000000000000000000000000000000044442221232333232313131131312323211222321121112213311222312332223133222244444440000000000000000000000000
00000000000000000000000000000000000000000000004441112332332323313331122321323131333231221231223232222233311332212314444444400000000000000000000000000
00000000000000000000000000000000000000000000000444244333232332232133213221232113233333331131112122312311131223223144444440000000000000000000000000000
00000000000000000000000000000000000000000000000000444423332233232222311233323111212312211133221323131123133133344444444000000000000000000000000000000
00000000000000000000000000000000000000000000000000044444443443232213333222213122321113212233121311234444444444444444400000000000000000000000000000000
00000000000000000000000000000000000000000000000000000000444444444444444444444444444444444444444444444440000000000000000000000000000000000000000000000
00000000000000000000000000000000000000000000000000000000000000444444444444444444444444444444444000000000000000000000000000000000000000000000000000000
00000000000000000000000000000000000000000000000000000000000000000000000000000000000000000000000000000000000000000000000000000000000000000000000000000
00000000000000000000000000000000000000000000000000000000000000000000000000000000000000000000000000000000000000000000000000000000000000000000000000000
00000000000000000000000000000000000000000000000000000000000000000000000000000000000000000000000000000000000000000000000000000000000000000000000000000
00000000000000000000000000000000000000000000000000000000000000000000000000000000000000000000000000000000000000000000000000000000000000000000000000000
00000000000000000000000000000000000000000000000000000000000000000000000000000000000000000000000000000000000000000000000000000000000000000000000000000
