00000000000000000000000000000000000000000000000000000000000000000000000000000000000000000000000000000000000000000000000000000000000000000000000000000
00000000000000000000000000000000000000000000000000000000000000000000000000000000000000000000000000000000000000000000000000000000000000000000000000000
00000000000000000000000000000000000000000000000000000000000000000000000000000000000000000000000000000000000000000000000000000000000000000000000000000
00000000000000000000000000000000000000000000000000000000000000000000000000000000000000000000000000000000000000000000000000000000000000000000000000000
00000000000000000000000000000000000000000000000000000000000000000000000000000000000000000000000000000000000000000000000000000000000000000000000000000
00000000000000000000000000000000000000000000000000000000000000000000000000000000000000000000000000000000000000000000000000000000000000000000000000000
00000000000000000000000000000000000000000000000000000000000000000000000000000000000000000000000000000000000000000000000000000000000000000000000000000
00000000000000000000000000000000000000000000000000000000000000000000000000000000000000000000000000000000000000000000000000000000000000000000000000000
00000000000000000000044444444444444444444444444444444444444444444444444444444444444444444444444444444444444000000000000000000000000000000000000000000
00000000000000000044444223233221122123313212133113322321211112331223233331221113121132121232322212223311132400000000000000000000000000000000000000000
00000000000000000444221312133211332111211233121221121131333122323113321323222221313323313121332311111222122440000000000000000000000000000000000000000
00000000000000000432211322231133123311323112323223212111313233332313323322332312323233112221132111333113323144000000000000000000000000000000000000000
00000000000000000423222213222121312233111122231113112213123321313232211112321223213231133132322231123311331134440000000000000000000000000000000000000
00000000000000000412231112223232321233322123221222313132122211332331312113312121111311321113231212213221323234444000000000000000000000000000000000000
00000000000000000044111133111311333313311311213333211312111113122133231311123111321211332332323212112111332212444400000000000000000000000000000000000
00000000000000000044121112311232223232121323212233331332333121233232332221321233131321113321313313322332221312144440000000000000000000000000000000000
00000000000000000000411132312212213311223323131323333332123211223323212133132121112313123221212331213131313231312340000000000000000000000000000000000
00000000000000000000012331221221321312313122221311233221321131121221222123222131212313222122322331131333233122112244000000000000000000000000000000000
00000000000000000000002112112323221132133233213313131122331112131222112123311332222221331332133332233312213133333444400000000000000000000000000000000
00000000000000000000000412133121111321221333231232121112332131322131223322122223212332321322133312122232332212211344440000000000000000000000000000000
00000000000000000000000041122331112323313133312212121213321233113321223311332211331112312322223122223313113311323344444000000000000000000000000000000
00000000000000000000000004323113322331111323312123312311332211212111112231131322111222312232322213331123221231231124444000000000000000000000000000000
00000000000000000000000000441133212213123322312122333331312111212321232311112113313321213312231222331232221211321223444400000000000000000000000000000
00000000000000000000000000042222113313133211223323211121233332111332222222331233331211211313112212313321222133312131444400000000000000000000000000000
00000000000000000000000000044123113112212132122313223333111211323323111223111113333123322131322332113222323211121122231400000000000000000000000000000
00000000000000000000000000004412213122123123121233211322232223332213211331123323132323331211122133213112113312232223133414400000000000000000000000000
00000000000000000000000000000444311121231321222331332112121111212322323222212132211222123313331321112121111232213133312444400000000000000000000000000
00000000000000000000000000000004413222133323121223333332131311212331313112212212121221313312131113312123321213222231322324400000000000000000000000000
00000000000000000000000000000004422213121121213213232231312322121331123313331223122332131322331123113332323311333212211144400000000000000000000000000
00000000000000000000000000000000442221211112132332113213111232311331131331323323123132322122131233122221312333112131233244440000000000000000000000000
00000000000000000000000000000000044332112133323212122113132223223321122221312211232112123313332322333311211123322232123244440000000000000000000000000
00000000000000000000000000000000004411321121233311132333333211323113212223232133222331123232231222133313221333112122212134444000000000000000000000000
00000000000000000000000000000000004213131221331222322212131312223212321221211313331323131211232231211131232233322212212424440400000000000000000000000
00000000000000000000000000000000000044213111223332323222333211331132332312123113213221211213123333113323332213333322222344444400000000000000000000000
00000000000000000000000000000000000044412313312333121113121323323331233313333333322112322121233321212321122323313311112344440400000000000000000000000
00000000000000000000000000000000000000442212133131322333122121221232331312331122322211232211322223212233131322222311333223444000000000000000000000000
00000000000000000000000000000000000000044211223132133121113131212223332222333322213133333321321312232312112221131323213144444400000000000000000000000
00000000000000000000000000000000000000004423331112321312223323233221211231323323222132313232323222322132332312112131211144444400000000000000000000000
00000000000000000000000000000000000000004443333232213312122321112133121323323212212223122322321321212133223331333322232114444400000000000000000000000
00000000000000000000000000000000000000000444313311223232232311132331322113113332212123111221131123312113333231232113211224444400000000000000000000000
00000000000000000000000000000000000000000044423311331211323232312111331231111132122311313131212311322331131313322323332344444000000000000000000000000
00000000000000000000000000000000000000000000444211133132122333331333213213222313233213112123123122333132133332223321232442100000000000000000000000000
00000000000000000000000000000000000000000000044442322133321331212122311122321321212311213113122223123112122123112322344422000000000000000000000000000
00000000000000000000000000000000000000000000004441332313311131321113322112331321333122312231313121231111232221222334444301000000000000000000000000000
00000000000000000000000000000000000000000000000444244332233312323311331321332133313233313333133333322112111232212144440000000000000000000000000000000
00000000000000000000000000000000000000000000000000444433221332331212122222112333111331322211111311223122331233344424000000000000000000000000000000000
00000000000000000000000000000000000000000000000000044444442442223332213313232331332213212223132132234444444444444400000000000000000000000000000000000
00000000000000000000000000000000000000000000000000000000444444444444444444444444444444444444444444440000000000000000000000000000000000000000000000000
00000000000000000000000000000000000000000000000000000000000000444444444444444444444444444444444000000000000000000000000000000000000000000000000000000
00000000000000000000000000000000000000000000000000000000000000000000000000000000000000000000000000000000000000000000000000000000000000000000000000000
00000000000000000000000000000000000000000000000000000000000000000000000000000000000000000000000000000000000000000000000000000000000000000000000000000
00000000000000000000000000000000000000000000000000000000000000000000000000000000000000000000000000000000000000000000000000000000000000000000000000000
00000000000000000000000000000000000000000000000000000000000000000000000000000000000000000000000000000000000000000000000000000000000000000000000000000
00000000000000000000000000000000000000000000000000000000000000000000000000000000000000000000000000000000000000000000000000000000000000000000000000000
