00000000000000000000000000000000000000000000000000000000000000000000000000000000000000000000000000000000000000000000000000000000000000000000000000000
00000000000000000000000000000000000000000000000000000000000000000000000000000000000000000000000000000000000000000000000000000000000000000000000000000
00000000000000000000000000000000000000000000000000000000000000000000000000000000000000000000000000000000000000000000000000000000000000000000000000000
00000000000000000000000000000000000000000000000000000000000000000000000000000000000000000000000000000000000000000000000000000000000000000000000000000
00000000000000000000000000000000000000000000000000000000000000000000000000000000000000000000000000000000000000000000000000000000000000000000000000000
00000000000000000000000000000000000000000000000000000000000000000000000000000000000000000000000000000000000000000000000000000000000000000000000000000
00000000000000000000000000000000000000000000000000000000000000000000000000000000000000000000000000000000000000000000000000000000000000000000000000000
00000000000000000000000000000000000000000000000000000000000000000000000000000000000000000000000000000000000000000000000000000000000000000000000000000
00000000000000000000044444444444444444444444444444444444444444444444444444444444444444444444444444444444444000000000000000000000000000000000000000000
00000000000000000044444332222312121212113113113323221121233222121133232123122222111221222223322131313222112400000000000000000000000000000000000000000
00000000000000000444123122121111213121323132211132112331231132323221332211233322213231111321111231312111213440000000000000000000000000000000000000000
00000000000000000433112222233312211113113313121333322131311221233331111221331212333112112323322213231332212144000000000000000000000000000000000000000
00000000000000000431122223111131121313112312132212232221233213122313123221312221333113331313322221223331113214440000000000000000000000000000000000000
00000000000000000423131113311122211222232211322213112123233312132331213133311332223232313313332111122311333124444000000000000000000000000000000000000
00000000000000000044211332333322133133333131121213131221131132312223322213211313232231131323122123313312233112444400000000000000000000000000000000000
00000000000000000044123112121332322123122333131111233122321223121323112133112322232221233223223331323332313333144440000000000000000000000000000000000
00000000000000000000423211121221332233133121131112111123312132132313112313311122231233332113211333322313111132111140000000000000000000000000000000000
00000000000000000000031131111322333223333331233211112311333231332133111211111122231321211113211333323222111331222344000000000000000000000000000000000
00000000000000000000003123311332131223121113111323111111322333122332333313323232132321211221213131312122311133312444400000000000000000000000000000000
00000000000000000000000422313213132322233233323232312112331211232123132212123222221121331123121132231121121121122144440000000000000000000000000000000
00000000000000000000000042332113213113322113131133223323112132113311121323211331311322231222312231311223113111212344444000000000000000000000000000000
00000000000000000000000004231221211131321133122233223232232332312312221213122132113321313123123311212332222211311124444000000000000000000000000000000
00000000000000000000000000441233111233211121112231322322213231222232311321332133111311222313121213221312131233113321444400000000000000000000000000000
00000000000000000000000000041311113213132312312231133311123212321323231231232221213232223131131311132223233112331222444400000000000000000000000000000
00000000000000000000000000044111313233132212122333131113223121333232122222222332233131333211233111233321312111232133221400000000000000000000000000000
00000000000000000000000000004423113213223232322211223222332322233231333213223121323313331123121212133112212331313232322414400000000000000000000000000
00000000000000000000000000000444311122133211221332332132132133131333133222211332333112333113122212212231323312221222133444400000000000000000000000000
00000000000000000000000000000004431111331221323223232131213133332222311233321222221321321233312213312233323211121233112324400000000000000000000000000
00000000000000000000000000000004421123131322223211313231111221222231331323132112321122123333232333222223313221311213333144400000000000000000000000000
00000000000000000000000000000000441223123213221331111231133221323112322231211133313332213313221312223313311133113311312344440000000000000000000000000
00000000000000000000000000000000044323113122123232111223312122313211212332213322312332331212223323212321133321121312213144440000000000000000000000000
00000000000000000000000000000000004431323232212311311332311122211133313122233231123122111211322323323211223332323212211334444000000000000000000000000
00000000000000000000000000000000004332121311213313321222221232223111133331123232331111213311232111123322222222333112311414440400000000000000000000000
00000000000000000000000000000000000044123322123313121122232222222211123111323223233212323331221332123321221331331133213244444400000000000000000000000
00000000000000000000000000000000000044411232112321122322123231333231332233333112311322222211133231222123211132133213331244440400000000000000000000000
00000000000000000000000000000000000000441222122323113113232113313123321112213222122121333132132111121112132133313112333223444000000000000000000000000
00000000000000000000000000000000000000044222222221331121113231222332132233331323112322111213111111231312232121213133232244444400000000000000000000000
00000000000000000000000000000000000000004423131222233313113112133232132322312323221111223313112333221223132212131221132344444400000000000000000000000
00000000000000000000000000000000000000004443222213212313211312311321133231112223332131111323111123333323112222112323111124444400000000000000000000000
00000000000000000000000000000000000000000444131123133112312121121121133133123231131221222233212133113212332233112312112114444400000000000000000000000
00000000000000000000000000000000000000000044423113321123333331121121321211131211222333322232111111332112112312112212331144444000000000000000000000000
00000000000000000000000000000000000000000000444121321323213111323123223313212311233123222312123112122313333121213221212441200000000000000000000000000
00000000000000000000000000000000000000000000044442313111133313223321111323221231133221233113122223112112123323331213344411000000000000000000000000000
00000000000000000000000000000000000000000000004442122213231222231121133122111313133311212313322223311221333123331234444301000000000000000000000000000
00000000000000000000000000000000000000000000000444344131121313223122112312232211231211221321313123211311133331311344440000000000000000000000000000000
00000000000000000000000000000000000000000000000000444412111222121212333311121121232222233311313331222231312223244424000000000000000000000000000000000
00000000000000000000000000000000000000000000000000044444443443112231233322221112113232212121123211114444444444444400000000000000000000000000000000000
00000000000000000000000000000000000000000000000000000000444444444444444444444444444444444444444444440000000000000000000000000000000000000000000000000
00000000000000000000000000000000000000000000000000000000000000444444444444444444444444444444444000000000000000000000000000000000000000000000000000000
00000000000000000000000000000000000000000000000000000000000000000000000000000000000000000000000000000000000000000000000000000000000000000000000000000
00000000000000000000000000000000000000000000000000000000000000000000000000000000000000000000000000000000000000000000000000000000000000000000000000000
00000000000000000000000000000000000000000000000000000000000000000000000000000000000000000000000000000000000000000000000000000000000000000000000000000
00000000000000000000000000000000000000000000000000000000000000000000000000000000000000000000000000000000000000000000000000000000000000000000000000000
00000000000000000000000000000000000000000000000000000000000000000000000000000000000000000000000000000000000000000000000000000000000000000000000000000
