00000000000000000000000000000000000000000000000000000000000000000000000000000000000000000000000000000000000000000000000000000000000000000000000000000
00000000000000000000000000000000000000000000000000000000000000000000000000000000000000000000000000000000000000000000000000000000000000000000000000000
00000000000000000000000000000000000000000000000000000000000000000000000000000000000000000000000000000000000000000000000000000000000000000000000000000
00000000000000000000000000000000000000000000000000000000000000000000000000000000000000000000000000000000000000000000000000000000000000000000000000000
00000000000000000000000000000000000000000000000000000000000000000000000000000000000000000000000000000000000000000000000000000000000000000000000000000
00000000000000000000000000000000000000000000000000000000000000000000000000000000000000000000000000000000000000000000000000000000000000000000000000000
00000000000000000000000000000000000000000000000000000000000000000000000000000000000000000000000000000000000000000000000000000000000000000000000000000
00000000000000000000044444444444444444444444444444444444444444444444444444444444444444444444444444444440000000000000000000000000000000000000000000000
00000000000000044444444444444444444444444444444444444444444444444444444444444444444444444444444444444444444000000000000000000000000000000000000000000
00000000044444444444444233212213211133331133322211312123122323332123222321313322221113213133113221322132131400000000000000000000000000000000000000000
00000000441332312212133332223123233211131232133312331212132123113123322221332321322222111221121312313133233440000000000000000000000000000000000000000
00000000444133323123322332232213223221112223123222312122123131121131223231312232233221331122132221322231212244000000000000000000000000000000000000000
00000000044432222323321211122222331313233212332131222113113311231112213121133133231112211333133131323333111124440000000000000000000000000000000000000
00000000044331332311131313333312323132323232233111111333233212212212311331222333212212313211231132332222323214444000000000000000000000000000000000000
00000000004444321232331312123313332212232212232331112323122113333311331323132132123211211312222332313221121222444400000000000000000000000000000000000
00000000000004444221222221233131113312323122133232212122213213312111121331233212223123121111212321212221211312144440000000000000000000000000000000000
00000000000000044444421133113213122333132221211121112212312111232233211331211121322311312131232322232121322231311140000000000000000000000000000000000
00000000000000000044412133133131232121333212213123313213122322321333212331213111331112322312212133132121221111223244000000000000000000000000000000000
00000000000000000000443322123311332311213212131311333322133221112111111121311221332222233122123333322312333231113444400000000000000000000000000000000
00000000000000000000044431231233111133132223312113131223133331332231322331211132131223313332213231123121212313213144440000000000000000000000000000000
00000000000000000000004441121312132332122232113321133121312112212311333211111123223223231233312132232322113112121344444000000000000000000000000000000
00000000000000000000000044322111222323312222321123232111312112122231333233133212112323233121323121312122233111121224444000000000000000000000000000000
00000000000000000000000004443312213332321113112121311211321122322223323322211323333332211122112213331323133231123311444400000000000000000000000000000
00000000000000000000000000442231111231322323323331333221111111123232213313221222122322121311211121132123233331333312444440000000000000000000000000000
00000000000000000000000000444232322122323332133331313212122131132131131221123213333232211133332311323111132323332332313440000000000000000000000000000
00000000000000000000000000044423312233223232233212133212333121231221331123212123321212232312213322212133133322212232211444400000000000000000000000000
00000000000000000000000000004444113112232213211133121221321113211222131313211313212123322132233121123333233312211312113444400000000000000000000000000
00000000000000000000000000000044432131313112111113222331132323223123233331211221122212122232132212213212321112222311323224400000000000000000000000000
00000000000000000000000000000004422233333331121121311112212111121113322313233322332131211123213221213132213332223213323244400000000000000000000000000
00000000000000000000000000000000441233113131133111221333223333121222232322323313321133211223132311233332323323331112333244440000000000000000000000000
00000000000000000000000000000000044121131333311223311222212333312213211122323123112111112212232323133333311132332223111244440000000000000000000000000
00000000000000000000000000000000004422331131123332222332132212322122331222221322322112222122212123323322111132331223221324444000000000000000000000000
00000000000000000000000000000000004333133321313131131221133332233123331113231213231221222213111111311331313123111221313414444400000000000000000000000
00000000000000000000000000000000000044311231112233223312312221323222133232213312222111111222121223122211333223331232113144444400000000000000000000000
00000000000000000000000000000000000044421212311222212221321313121311121112313312323323321221123332312112132232213121231144444400000000000000000000000
00000000000000000000000000000000000000442122321212321231312213113332331131312132221313222313233123113121311111211332111122444440000000000000000000000
00000000000000000000000000000000000000044111223211233133222213322222113223311123312211232313213222311331221223121331131344444440000000000000000000000
00000000000000000000000000000000000000004423323313332313313131331223212122321333132331121233132113313122232131133323312244444440000000000000000000000
00000000000000000000000000000000000000004441233333231223113133332211122133231231223332221332132321312231311323221223323324444440000000000000000000000
00000000000000000000000000000000000000000444331231312221122132213321232311112221131222232321323322322112331231311222331134444440000000000000000000000
00000000000000000000000000000000000000000044423232113332313131223312321321333113313132111231232231211222213311233333331144444400000000000000000000000
00000000000000000000000000000000000000000000444221232231321333332132121211132113121131333112111331331323311321121333111444444000000000000000000000000
00000000000000000000000000000000000000000000044443311212223122131111332313111233333213212133232131323321132121132331144444440000000000000000000000000
00000000000000000000000000000000000000000000004443123212133323131232112332112222212221211133331132322121131231222324444444400000000000000000000000000
00000000000000000000000000000000000000000000000444144331311121121113211131111322211222213311312112132332311233221144444440000000000000000000000000000
00000000000000000000000000000000000000000000000000444433311312131121223122131312213222321221212332221332331211244444444000000000000000000000000000000
00000000000000000000000000000000000000000000000000044444443443333311112333223312233131223232221222324444444444444444400000000000000000000000000000000
00000000000000000000000000000000000000000000000000000000444444444444444444444444444444444444444444444440000000000000000000000000000000000000000000000
00000000000000000000000000000000000000000000000000000000000000444444444444444444444444444444444000000000000000000000000000000000000000000000000000000
00000000000000000000000000000000000000000000000000000000000000000000000000000000000000000000000000000000000000000000000000000000000000000000000000000
00000000000000000000000000000000000000000000000000000000000000000000000000000000000000000000000000000000000000000000000000000000000000000000000000000
00000000000000000000000000000000000000000000000000000000000000000000000000000000000000000000000000000000000000000000000000000000000000000000000000000
00000000000000000000000000000000000000000000000000000000000000000000000000000000000000000000000000000000000000000000000000000000000000000000000000000
00000000000000000000000000000000000000000000000000000000000000000000000000000000000000000000000000000000000000000000000000000000000000000000000000000
