00000000000000000000000000000000000000000000000000000000000000000000000000000000000000000000000000000000000000000000000000000000000000000000000000000
00000000000000000000000000000000000000000000000000000000000000000000000000000000000000000000000000000000000000000000000000000000000000000000000000000
00000000000000000000000000000000000000000000000000000000000000000000000000000000000000000000000000000000000000000000000000000000000000000000000000000
00000000000000000000000000000000000000000000000000000000000000000000000000000000000000000000000000000000000000000000000000000000000000000000000000000
00000000000000000000000000000000000000000000000000000000000000000000000000000000000000000000000000000000000000000000000000000000000000000000000000000
00000000000000000000000000000000000000000000000000000000000000000000000000000000000000000000000000000000000000000000000000000000000000000000000000000
00000000000000000000000000000000000000000000000000000000000000000000000000000000000000000000000000000000000000000000000000000000000000000000000000000
00000000000000000000000000000000000000000000000000000000000000000000000000000000000000000000000000000000000000000000000000000000000000000000000000000
00000000000000000000044444444444444444444444444444444444444444444444444444444444444444444444444444444444444000000000000000000000000000000000000000000
00000000000000000044444313223122113311133113232233132322333311312121313223333223133213122211221323211113213400000000000000000000000000000000000000000
00000000000000000444212232133133212221331313211133123331212112121231132122123121222222331233213112113111233440000000000000000000000000000000000000000
00000000000000000411312322312121232313333323233231231111211231123212132313221322131313111233132223223221131244000000000000000000000000000000000000000
00000000000000000431133132111123312332113312233223323321123132331213133112122212222333323223312233111331323114440000000000000000000000000000000000000
00000000000000000432213223213311213332232131322223221113121213311213131131111222312122211312323233322223213124444000000000000000000000000000000000000
00000000000000000044133112111232323122312332233132123322331233121111331221323222311323321211131113112123122122444400000000000000000000000000000000000
00000000000000000044333222313232321212223332222323122133213323111113332223132312312122331122231331223113222121144440000000000000000000000000000000000
00000000000000000000431232213211311113313331233212322122322322121223312222312331223232131123232131133223322133132140000000000000000000000000000000000
00000000000000000000012213121311312123211333323223122222333232111222221133321123113313212211121232113323333133112144000000000000000000000000000000000
00000000000000000000001233112231312321223123212222232311232133322133123312332131233222132331211231223332121212323444400000000000000000000000000000000
00000000000000000000000412322131311321313311113233121312122122311233323133233123213212313313233223311232232133122244440000000000000000000000000000000
00000000000000000000000042111223311212331112221122312113321312332211221231122122111212111133311221311122223223231344444000000000000000000000000000000
00000000000000000000000004112321323312122221211221331321313131111311132132221233133112112332321222111231133122113314444000000000000000000000000000000
00000000000000000000000000442111213221222123321113313232131222333212112132222121331123321323132121313111312323222223444400000000000000000000000000000
00000000000000000000000000041321333221312211322332123311322331222311231323333212312112311322313321112313222213231112444400000000000000000000000000000
00000000000000000000000000044221332331111311112333213231321232323322132133122323233221333311333131333312332331131212122400000000000000000000000000000
00000000000000000000000000004432111111123332312112323312132331331321311333111333222321213123221231133233232132221212311414400000000000000000000000000
00000000000000000000000000000444313131121232132113212112313132123323132211322113222312223213123112233132322333313132231444400000000000000000000000000
00000000000000000000000000000004421221111331121211232213331132133232332123121313112211121131133212213111333233121121123214400000000000000000000000000
00000000000000000000000000000004423312312212233331213123323313321133221221322231132212131311321323323321313211211222223144400000000000000000000000000
00000000000000000000000000000000441212233121111121232211322113133313122331312211131231122222322321133122112313313222311244440000000000000000000000000
00000000000000000000000000000000044212121323212132222122311111212312211223332113213313333131221311331212132222323122112344440000000000000000000000000
00000000000000000000000000000000004433223332111222222221121333211212322312321332123213121133133222233223133332112211112214444000000000000000000000000
00000000000000000000000000000000004121333113121211323233111131131111132122121223233221322331332313322133122322112223322424440400000000000000000000000
00000000000000000000000000000000000044212211211332112333212223313332222312323132111331212313113222322123233332113322111144444400000000000000000000000
00000000000000000000000000000000000044432313321231131131233332112133131323221132322212223311121313222211322123223113222144440400000000000000000000000
00000000000000000000000000000000000000441331213111211312122333132222112313223122132131313322132323233323233322113232122133444000000000000000000000000
00000000000000000000000000000000000000044323113231311233311333311132232221122312111331223132333231122123222122313212221144444400000000000000000000000
00000000000000000000000000000000000000004431312132231323213331122132221221223133231221132213312312332133312312222322123144444400000000000000000000000
00000000000000000000000000000000000000004443323323323232331122323332111233212213311113222123133333122213232121323131221314444400000000000000000000000
00000000000000000000000000000000000000000444112113233223122223231313212123333212221221223333212113212331322233323233332314444400000000000000000000000
00000000000000000000000000000000000000000044431331131112233111133121122132333221123122111111121313111332233311331131322144444000000000000000000000000
00000000000000000000000000000000000000000000444132122333121223133211323121131213223212321132213232321332232333221222222441300000000000000000000000000
00000000000000000000000000000000000000000000044442211113131331121121312131313123211231132333331323321212123123111133344412000000000000000000000000000
00000000000000000000000000000000000000000000004442332111133333221212211113332231331111121212121223332121333221233314444102000000000000000000000000000
00000000000000000000000000000000000000000000000444144233232332321112333323332212223131111313331123211121222222223244440000000000000000000000000000000
00000000000000000000000000000000000000000000000000444413133222332111212121113131313221321112132323322232331331344414000000000000000000000000000000000
00000000000000000000000000000000000000000000000000044444443441313331113133222313312232333331313333124444444444444400000000000000000000000000000000000
00000000000000000000000000000000000000000000000000000000444444444444444444444444444444444444444444440000000000000000000000000000000000000000000000000
00000000000000000000000000000000000000000000000000000000000000444444444444444444444444444444444000000000000000000000000000000000000000000000000000000
00000000000000000000000000000000000000000000000000000000000000000000000000000000000000000000000000000000000000000000000000000000000000000000000000000
00000000000000000000000000000000000000000000000000000000000000000000000000000000000000000000000000000000000000000000000000000000000000000000000000000
00000000000000000000000000000000000000000000000000000000000000000000000000000000000000000000000000000000000000000000000000000000000000000000000000000
00000000000000000000000000000000000000000000000000000000000000000000000000000000000000000000000000000000000000000000000000000000000000000000000000000
00000000000000000000000000000000000000000000000000000000000000000000000000000000000000000000000000000000000000000000000000000000000000000000000000000
