0302010203010103
0303020103010101
0203030101030203
0101020203010302
0301010301020102
0301020201010302
0103020102020201
0101010201020303
