0302030303010103
0101030301020302
0103020101010201
0202030102020201
0103010202030302
0102030103030103
0301030303010103
0102020303020101
