00000000000000000000000000000000000000000000000000000000000000000000000000000000000000000000000000000000000000000000000000000000000000000000000000000
00000000000000000000000000000000000000000000000000000000000000000000000000000000000000000000000000000000000000000000000000000000000000000000000000000
00000000000000000000000000000000000000000000000000000000000000000000000000000000000000000000000000000000000000000000000000000000000000000000000000000
00000000000000000000000000000000000000000000000000000000000000000000000000000000000000000000000000000000000000000000000000000000000000000000000000000
00000000000000000000000000000000000000000000000000000000000000000000000000000000000000000000000000000000000000000000000000000000000000000000000000000
00000000000000000000000000000000000000000000000000000000000000000000000000000000000000000000000000000000000000000000000000000000000000000000000000000
00000000000000000000000000000000000000000000000000000000000000000000000000000000000000000000000000000000000000000000000000000000000000000000000000000
00000000000000000000000000000000000000000000000000000000000000000000000000000000000000000000000000000000000000000000000000000000000000000000000000000
00000000000000000000044444444444444444444444444444444444444444444444444444444444444444444444444444444444444000000000000000000000000000000000000000000
00000000000000000044444113311311223212322131223123333131221323322323333332223323331122322112131312122322311400000000000000000000000000000000000000000
00000000000000000444332313123113222133312131133132311311131323331313333132113231222312323232113111122312333440000000000000000000000000000000000000000
00000000000000000433311333113123323332122223311222111122123333323223311321233122131132322312123123211233233144000000000000000000000000000000000000000
00000000000000000413222121223321331333223123121331222211212131113122311313123131321111333232132333211232212214440000000000000000000000000000000000000
00000000000000000422312323221131111323323212111233133131333211312321121332212223123232212211213233212231132224444000000000000000000000000000000000000
00000000000000000044223312132232211111121323132133232231232211131321313123313333122223322212222111231121133113444400000000000000000000000000000000000
00000000000000000044331132333132112223231111232332122212112313112232311111333222313212211113113113333333131223244440000000000000000000000000000000000
00000000000000000000433221213212232233123231232311111221313113112111333212111323121122131222112311212132132122312240000000000000000000000000000000000
00000000000000000000011322311322132132212132121233321313323211111111133132232121233113321211133223321311232231133144000000000000000000000000000000000
00000000000000000000002221333112133133232222221212122111123121323213112123321232232133223311112223212111113233121444400000000000000000000000000000000
00000000000000000000000431133122231133321323233221113133312222122133222311232211231123323231112131222311132111213144440000000000000000000000000000000
00000000000000000000000042131232333212222322223221313231133111213211223311332211122333223112212212211112211233111144444000000000000000000000000000000
00000000000000000000000004132233222132333233313221312333231112312112222333112112321113121133112311211123231131311124444000000000000000000000000000000
00000000000000000000000000441233112123322111112211132322212231332223332122213222222112211222313111223121132112122123444400000000000000000000000000000
00000000000000000000000000041133221221131231111133323132331121212333313133332122111331121111331121212321313332313131444400000000000000000000000000000
00000000000000000000000000044222122233322323323213231113323223132311312212123321212121312221332312232313211212313333113400000000000000000000000000000
00000000000000000000000000004431331221331312112323331133112123121222213232333211123123312332133132331221212332233311313414400000000000000000000000000
00000000000000000000000000000444221221311231211321313211223322223331123333112322311323133332331331133123112233211221211444400000000000000000000000000
00000000000000000000000000000004411333323233211133231322131311332121213332121311333233321212322231231322322121123332313324400000000000000000000000000
00000000000000000000000000000004413313131221111113313323121213112113112231121111231212312223222323122111322111231113131344400000000000000000000000000
00000000000000000000000000000000441313222111331313232221333332123311222131331232113333333213323313211132122312231322131344440000000000000000000000000
00000000000000000000000000000000044323133332112231121323331222131222212212121111233323221223122231121212222133312131223144440000000000000000000000000
00000000000000000000000000000000004431111312312313133212132313132213111133312311122133113133212312232121333332333312223214444000000000000000000000000
00000000000000000000000000000000004221133231311231333221323111132211211232312112122312223311213123231321211323231221211434440400000000000000000000000
00000000000000000000000000000000000044133212121322111311122112322333322233331121222133213333233112211332221332313123313244444400000000000000000000000
00000000000000000000000000000000000044432211223132332122112312133323311111312131222233123321221321211113332223222221222144440400000000000000000000000
00000000000000000000000000000000000000443132332311223312213122222121333233122222123122122122233132313313132123321133332312444000000000000000000000000
00000000000000000000000000000000000000044333212223233332213233323311212231132312123231232331322313223312123213332213131244444400000000000000000000000
00000000000000000000000000000000000000004432222333233112123332331223333333311211332123113312213112121231231223322121223144444400000000000000000000000
00000000000000000000000000000000000000004443133211113213313233232222313132232332112132321131111232221113331231312322331234444400000000000000000000000
00000000000000000000000000000000000000000444221111233133213331212112213111121211333311323131133122323232323121232231221334444400000000000000000000000
00000000000000000000000000000000000000000044412313333333313233123123223111233133321122231221331312221232221111313132131244444000000000000000000000000
00000000000000000000000000000000000000000000444333112123122113312333113312131122213323113112121332312321132313322321232441300000000000000000000000000
00000000000000000000000000000000000000000000044443111132132112233322312232232321223211221312333112312121332133132132144422000000000000000000000000000
00000000000000000000000000000000000000000000004442331131331211323311121112322123121223222321331331113312213111111234444103000000000000000000000000000
00000000000000000000000000000000000000000000000444244133331313223323321233122221322211121332221321231233322222323244440000000000000000000000000000000
00000000000000000000000000000000000000000000000000444412212312112212111331311112323223122122212123311121232131144414000000000000000000000000000000000
00000000000000000000000000000000000000000000000000044444443441132332322113133113113132322313311132134444444444444400000000000000000000000000000000000
00000000000000000000000000000000000000000000000000000000444444444444444444444444444444444444444444440000000000000000000000000000000000000000000000000
00000000000000000000000000000000000000000000000000000000000000444444444444444444444444444444444000000000000000000000000000000000000000000000000000000
00000000000000000000000000000000000000000000000000000000000000000000000000000000000000000000000000000000000000000000000000000000000000000000000000000
00000000000000000000000000000000000000000000000000000000000000000000000000000000000000000000000000000000000000000000000000000000000000000000000000000
00000000000000000000000000000000000000000000000000000000000000000000000000000000000000000000000000000000000000000000000000000000000000000000000000000
00000000000000000000000000000000000000000000000000000000000000000000000000000000000000000000000000000000000000000000000000000000000000000000000000000
00000000000000000000000000000000000000000000000000000000000000000000000000000000000000000000000000000000000000000000000000000000000000000000000000000
