00000000000000000000000000000000000000000000000000000000000000000000000000000000000000000000000000000000000000000000000000000000000000000000000000000
00000000000000000000000000000000000000000000000000000000000000000000000000000000000000000000000000000000000000000000000000000000000000000000000000000
00000000000000000000000000000000000000000000000000000000000000000000000000000000000000000000000000000000000000000000000000000000000000000000000000000
00000000000000000000000000000000000000000000000000000000000000000000000000000000000000000000000000000000000000000000000000000000000000000000000000000
00000000000000000000000000000000000000000000000000000000000000000000000000000000000000000000000000000000000000000000000000000000000000000000000000000
00000000000000000000000000000000000000000000000000000000000000000000000000000000000000000000000000000000000000000000000000000000000000000000000000000
00000000000000000000000000000000000000000000000000000000000000000000000000000000000000000000000000000000000000000000000000000000000000000000000000000
00000000000000000000000000000000000000000000000000000000000000000000000000000000000000000000000000000000000000000000000000000000000000000000000000000
00000000000000000000044444444444444444444444444444444444444444444444444444444444444444444444444444444444444000000000000000000000000000000000000000000
00000000000000000044444333311331332131223313323212122132221131222321311323323112313323321121312221211323122400000000000000000000000000000000000000000
00000000000000000444122112212322233231122312121231131323213113231213311133322111212222132331121331122333112440000000000000000000000000000000000000000
00000000000000000411221313112132212311222211333111323211222333233211113221222322311123222111233321113112332244000000000000000000000000000000000000000
00000000000000000432111133321112332331223332132213312212231132123211133333331313312331223221122333211123212324440000000000000000000000000000000000000
00000000000000000433122321132213233321232311111123112321221212131133211212312321333322213331231332212213313224444000000000000000000000000000000000000
00000000000000000044322121113213132123233111112133321121132333312123222323121111331231213113312311121111333132444400000000000000000000000000000000000
00000000000000000044133333331212122233131313121123122131321112311333311233211322231322111331313131211313311112244440000000000000000000000000000000000
00000000000000000000413333213122122313112132322221221232231121221313132132323322313321331213112113232212112111213240000000000000000000000000000000000
00000000000000000000023131313212322111323211131332321311312332131211212123232121232111222312333221113313231212232344000000000000000000000000000000000
00000000000000000000001232232211332221112321233122112323231223212321111223223213333222213122222221313232211222113444400000000000000000000000000000000
00000000000000000000000421113112331332312311131332333232223222132311321323122213232313131113312313232333332233332244440000000000000000000000000000000
00000000000000000000000042231323323223123113212322312131132233113311221232231112311223231213333223312121132123123244444000000000000000000000000000000
00000000000000000000000004122211111331312111213123211222321222311322211121313332221111332312132333113212231233221124444000000000000000000000000000000
00000000000000000000000000443222112133312111311132133222221213311222231321313313131123121222111121313232311222223231444400000000000000000000000000000
00000000000000000000000000043311331111323112111133133133132311232231112133132131333222122112221212322133322333332231444400000000000000000000000000000
00000000000000000000000000044232132231332123323331212212133121222231332221123321313232121122313222131333222121211113221400000000000000000000000000000
00000000000000000000000000004413332131211122213122321133313323113233111211213323213311112333332333112211312233213223122414400000000000000000000000000
00000000000000000000000000000444231131311232133221313312323232132323333311212332122211222313211131331123311233132233122444400000000000000000000000000
00000000000000000000000000000004431131123232131321231213332322113211333331323322111333211233221312232111222131312131311214400000000000000000000000000
00000000000000000000000000000004431111232211221112112313322112321122211121333332122231233322312111131333112332233332333244400000000000000000000000000
00000000000000000000000000000000442231223322231131311123121213223313131132333311311213211231123212111112132311112132331244440000000000000000000000000
00000000000000000000000000000000044311323131223233321121112313121113121233312212131313221232331233222232323222121323123144440000000000000000000000000
00000000000000000000000000000000004433131332231122113123131321211331122233323332131123332131333113321333313332213222121334444000000000000000000000000
00000000000000000000000000000000004333333321322331333322322131332232111223112331211321222232132323311233333233323112123414440400000000000000000000000
00000000000000000000000000000000000044233233131222322233231122211322133133112133133311212231213111233212313212311333112344444400000000000000000000000
00000000000000000000000000000000000044431111123112311213131312121133333111333232321213112323212132222222113133133323321344440400000000000000000000000
00000000000000000000000000000000000000441112121133332332232111211331311222112233311333131112313213331221312333233232222131444000000000000000000000000
00000000000000000000000000000000000000044222122312221133222321333131132232123113231222231331222121332123313121233112113344444400000000000000000000000
00000000000000000000000000000000000000004411222312322312222111131313312222223112213213131112221133311322311321311122312244444400000000000000000000000
00000000000000000000000000000000000000004441312233211213133121211313313311111231322333122122233231231323233331223221331214444400000000000000000000000
00000000000000000000000000000000000000000444222222333221221231233111222111213222231311312321213223311133131312122311321324444400000000000000000000000
00000000000000000000000000000000000000000044421132331223121222111121211331121333312323311321312113232231313321222222312244444000000000000000000000000
00000000000000000000000000000000000000000000444113123233221323211313332212223212122212231321131113313123133112221113312441300000000000000000000000000
00000000000000000000000000000000000000000000044443112313331231221322323331112212213322112122131323232321313223333122144411000000000000000000000000000
00000000000000000000000000000000000000000000004443321322231322222233221111332211121113123311221222123212233323112114444102000000000000000000000000000
00000000000000000000000000000000000000000000000444344222131133132131131223212223221332223333323123223333133123311344440000000000000000000000000000000
00000000000000000000000000000000000000000000000000444432221321223211232213113122322112122213313231313323221213144424000000000000000000000000000000000
00000000000000000000000000000000000000000000000000044444441443312232131211212232123211112211123133234444444444444400000000000000000000000000000000000
00000000000000000000000000000000000000000000000000000000444444444444444444444444444444444444444444440000000000000000000000000000000000000000000000000
00000000000000000000000000000000000000000000000000000000000000444444444444444444444444444444444000000000000000000000000000000000000000000000000000000
00000000000000000000000000000000000000000000000000000000000000000000000000000000000000000000000000000000000000000000000000000000000000000000000000000
00000000000000000000000000000000000000000000000000000000000000000000000000000000000000000000000000000000000000000000000000000000000000000000000000000
00000000000000000000000000000000000000000000000000000000000000000000000000000000000000000000000000000000000000000000000000000000000000000000000000000
00000000000000000000000000000000000000000000000000000000000000000000000000000000000000000000000000000000000000000000000000000000000000000000000000000
00000000000000000000000000000000000000000000000000000000000000000000000000000000000000000000000000000000000000000000000000000000000000000000000000000
